Rank,Wallet Address,City Rank Points,Prime Roll Points,Met Deposit Points,Fuel Tank Points,Hood Boost Points,Total Points
1,0x3e5d9c8d36f0a5eaba51659f613bcd0060ea25a6,60878,350,0,5585,6000,72813
2,0x709c27ee2c0688893ff061f9dcdb6e0f0c5e8533,58847,0,1320,3599,8000,71766
3,0x3899a5f877e84f515d88ecf2a0afc7e2d33e8b1d,57066,0,0,0,4000,61066
4,0x5a9d482df493b57d081b3fc885298abe19b403ec,42620,0,1887,3452,8000,55959
5,0x6aa8d2800b2d7ab7cbae44552291338a53934f17,38246,0,1903,0,8000,48149
6,0xe37868521a8da08b159e1aef98217134dea78183,40127,0,0,6500,1000,47627
7,0xeeba922a2445164143f16a171bc6a564d03a4f1a,27928,250,0,2117,15000,45295
8,0x1a0f228bf181bca9b7462cf063e757d2853f2ca2,35281,0,0,1882,6000,43163
9,0x0d088b4cdbef3d1d4a29d5958b5c334a0c4d55b0,17850,15150,0,3928,6000,42928
10,0x05fc37e11814199e9c16482492c1204f64a6463c,33891,650,523,0,6000,41064
11,0x513e628af5f1421906120ba8d1a90a996b85a184,21470,0,0,3250,10000,34720
12,0x239d7273d42d6e82ab0446941860f67dc5ac9d14,21099,4850,0,2000,4000,31949
13,0x48a5203b29c5bd1f6fe7deb45b6d92b8e5713193,11930,3450,6285,5595,4000,31260
14,0xc952865f0d3f5b152c3bd7772b23d655e272641c,17658,1100,0,2790,6000,27548
15,0xb3e666752177a5da3823ddadee3ce7be86846435,18066,0,0,1105,6000,25171
16,0x8f052c26f086a90059b53d269ea44b79c6be255b,12738,4950,0,1260,6000,24948
17,0x3e57743d458f109b0359303fe960469588fb08cd,13427,0,0,2950,8000,24377
18,0x553aacf16e6496f2778d810ae37352c6342bd854,19154,0,0,0,4000,23154
19,0x63a70c3474abe7ed5a8bf9d846929f713e82bbe4,13763,1550,1405,3700,2500,22918
20,0x912d63a77fe62b79c3348d60dcf1faf33137e719,16313,0,0,1750,4000,22063
21,0xc44622efe9f7b4c880e563548148810b9ce0cdb4,12112,0,0,3600,6000,21712
22,0xc7f5656ab456f46d5fd4c70280a015d2e0a1f80f,13195,1000,0,1208,6000,21403
23,0x4a4ab5d39cb74bfa6a56b09e55f5c5f49eda42c6,14873,350,0,1632,4000,20855
24,0xb4949f080b566d79d1c3535babb5876a819b9842,15376,0,0,2480,2500,20356
25,0xb61276ceadc462fe76e137fde30e7aa4a977f46c,11097,0,0,679,8000,19776
26,0x30fbc724b32989d9852074a6b8ce0c35fd5ff51e,12786,0,0,944,6000,19730
27,0x1d807b8fec9903e7b69edd01f9e592015366eec9,13887,0,0,1487,4000,19374
28,0xe3bac3c1173452618ce91e5653b0b715903338c3,10257,0,0,986,8000,19243
29,0x5efd728345b367bccd30648bbe31e01d15b0af62,11684,600,0,918,6000,19202
30,0xb6b17a7d626b4c1bb693b7d22336d57b3ebb7658,11188,0,0,2000,6000,19188
31,0x7bb54506f082b3322ec1a671eb37d57d29947cfb,10517,3200,0,1129,4000,18846
32,0xc2a29ea10e3560aeccfa107dd80a51c880ac1886,11769,0,0,720,6000,18489
33,0xf758536988f95aa278a872031c3068c61e302cc5,11286,150,0,2648,4000,18084
34,0xfda5f22a28753d6c4dc74da4e522caa04234c606,11761,0,0,0,6000,17761
35,0xfd2446c4dee1a1cf8876286c54b9abbc4a572231,4328,7250,0,2000,4000,17578
36,0x78b8d3f5edd31254e068401416001eb1be48aca4,5180,4150,0,0,8000,17330
37,0xcd3ea9baee068854472d2cd274464fdd9025f87b,5911,0,0,3300,8000,17211
38,0xcf378dfd582b66aa8b6025078f0ab3fab39c67f8,8546,0,226,0,8000,16772
39,0x085729eec537e05e173dd919939980aa652f8c2f,9386,0,0,1355,6000,16741
40,0xab974ac16d4e909aa9ff2e4b5edeffb0e73cdf4c,9049,750,0,2890,4000,16689
41,0xebe7dc01e9cb3af68f940e8fbc0f752697617f82,9602,0,0,900,6000,16502
42,0xe1d1ee2e8ed4f96b104be09b83d3f70a5f064dd1,12962,550,0,485,2500,16497
43,0x7d82ae7c8ad76f0ef821606138f389a21316c664,8067,350,0,0,8000,16417
44,0x506c4c4325b133b9dc277b00b58b01c606ac6ddd,5403,0,0,1000,10000,16403
45,0x86bb380114eb2137a73d8e6850400179d3da0e15,5241,0,0,2617,8000,15858
46,0x967c6ac377f2ec1e181df8363d28ddcaaaad0d40,2164,450,0,1215,12000,15829
47,0xce96f07e7254e914905f1b51d293da7936028651,5677,1250,0,616,8000,15543
48,0x5a17acdd2fe9ed469755c06a978d961f72776c46,5578,4800,0,800,4000,15178
49,0x37540857e19dfd92d51dfedbce418ac48d88efc4,11924,50,0,657,2500,15131
50,0xc366762a16e398825b08a8a21332dfd510ff5f80,6914,0,0,0,8000,14914
51,0x2f67a24aa434ea31f72e5b4930a788375dafe615,10481,0,0,383,4000,14864
52,0x2105751d4ff59e3ef29dbeb24c6069b9a5a3721d,8949,1500,0,300,4000,14749
53,0x93942d94425a487c3d1fcf3d89714b8606ca39b7,346,0,1868,8500,4000,14714
54,0x2b85fa7c882d47f6d4f982134eb6bc668c068b91,8315,0,307,0,6000,14622
55,0xda6620ac5b88470686b86a7310607d578dfd0f31,11003,0,0,1041,2500,14544
56,0x4b2c0b9bd6c19e34d980ac82edd9f9b846e26c6f,9709,0,0,700,4000,14409
57,0xe8a95dc1b7b2e1f503c3cdd2016541b135c97fec,10394,0,0,0,4000,14394
58,0xa8ca10a7fd38ca11e534018f3fac9796a426a397,7143,1350,0,1750,4000,14243
59,0x15b45ef34bfef22cb617bd05af99476d1d284f10,11659,0,0,0,2500,14159
60,0x63fee0fd3c4a174939b4a08df33392a3f3d3ee24,8909,950,0,300,4000,14159
61,0x103f95e213b51c97437659e9b8fee3b47a8aa53a,5617,0,0,400,8000,14017
62,0xa8aad55c115a9213d790e11ad90a60f3540fee72,7331,250,0,100,6000,13681
63,0x263371fca6cc06139d7f67d6fd69757997319183,6768,0,221,500,6000,13489
64,0x9be313209be2bf005942d4ddbafececde5f18b30,10963,0,0,0,2500,13463
65,0x0de34c2eada893485c116df0d10332c6e5796351,1691,650,0,800,10000,13141
66,0xd0ed6e7fc982ef10f443b781d2ac518ac6f8830a,8242,0,0,883,4000,13125
67,0x0abc78c93bfa2c94a097f793de3c6ab10a6fb7e6,2959,0,0,0,10000,12959
68,0xbcae8baa92e717d608e6d266df61d785b6f5dcbe,5476,1450,0,0,6000,12926
69,0x8a2a2ef12ba72be001d5f06992a9fb6e89647f32,11894,0,0,0,1000,12894
70,0xab9c2f0e78bcd1d9ac98367edfeb1532709ee16c,6288,150,0,396,6000,12834
71,0x11eb8c136cdc14ad1adcc24c463f18dd13a37447,5215,0,0,1600,6000,12815
72,0xc98b13345c6562b6790bb1abda331db437d1273f,5059,500,650,500,6000,12709
73,0xd595f140c2575d3e944332ea0b89f3ca08251704,5796,0,0,851,6000,12647
74,0x20de6eeb43ab26d39801d447d0a19bded9603f7c,4028,0,0,582,8000,12610
75,0x2bcfb8ca144290ec9051d7af922c9d74e74197da,6552,0,0,0,6000,12552
76,0x1f370f6c38a4888da33bb1d79e0fc01b3a51effb,5952,0,0,407,6000,12359
77,0x3c7522b1a0bd086f678b5de8aa7393336130d664,746,0,0,1466,10000,12212
78,0x36445ebc1b1f5c45fa7f5be69adcae1f7c6c31dd,1150,2550,0,400,8000,12100
79,0xbe782ec98ce7135a056e31300a9831fa35d52865,5171,500,0,200,6000,11871
80,0xb06fda87bde6fd294a1b51db1ef1474c2961e054,1261,0,0,500,10000,11761
81,0xacf4a8c1691c8c9b8f29e18746dc5e09c2d460aa,5691,0,0,0,6000,11691
82,0x3658a6713615cc4ea77409eacd6f098213d0cdbf,3000,0,0,600,8000,11600
83,0xf234622dc5bfe9639fe6c4a23cc16d399df4efd4,6734,0,0,622,4000,11356
84,0xdb4cbaa1186c69c0ac8311b25aa7dbca632da181,4778,1500,0,1063,4000,11341
85,0x9a93d7ddc0d8379c3c29eca87476a736b996d4b0,4771,0,0,545,6000,11316
86,0x0416071269eb7ca4055d53123e296d89fdf950a2,2682,0,0,600,8000,11282
87,0xdc0c0997c06cced62a416c6bab654fe306efc9fc,2086,0,0,1100,8000,11186
88,0xcf79e95e0e36c35cf206527815cc349a69f65e7e,6506,0,0,675,4000,11181
89,0xb5f1856fbbdd47e93efd14dab3d239558d915e5f,7169,300,0,3692,0,11161
90,0xef62dab1e70f596cd354289c5a9192038f938f6c,2654,0,0,400,8000,11054
91,0x498d742e6b94bb5215d5eea4b255b1649c26bec7,5830,800,0,400,4000,11030
92,0xd71a93f8cac73b80fc7753904bab97c21e694077,3781,2050,0,1000,4000,10831
93,0x6ac0e7cfa2d991dfc0e846616af8590cbe2f10cf,1745,0,0,6431,2500,10676
94,0x5f5df3da7e0e886fb99cd8cdd26e9c49b5cf168d,5748,0,601,313,4000,10662
95,0x366803790e0e92ba7b50fc7b93259c111a847f0e,1487,450,0,600,8000,10537
96,0xbda6a35390a38e0c87ababf55beaa2695b8df724,2124,0,0,400,8000,10524
97,0xc6d020de60083bfcbbf4f66e3dbf5e20c08f0e3e,265,0,0,250,10000,10515
98,0xf64d8ac3384838bb7280066ad5d5fab3c3ee3ec8,3893,0,0,2619,4000,10512
99,0x137a1770371d69f737250a466a16a6b88ec206f9,620,2850,0,945,6000,10415
100,0xab586a1762b7a89cd1498c4dd41caa56a2f211d7,4351,0,0,0,6000,10351
101,0xbb430f642ab027a895bb289744d9732ffacbca7a,6342,0,0,0,4000,10342
102,0xe7d6b9ca08557a1b2ee0d6c77add4013ac8c374d,6321,0,0,0,4000,10321
103,0x3178ef0bf0319ad5adf260b0e3b23bfe99fb3bbd,4933,1300,0,0,4000,10233
104,0x9137a5d195f0ab57e428c5a2be9bc8c4620445cb,3390,0,0,2827,4000,10217
105,0x3f9d51bf445ef9f14f4004359c08c9415dee8246,670,350,0,1040,8000,10060
106,0xa2f4dc54ed75bd7854d7e64762d84a55f0520767,1245,500,0,300,8000,10045
107,0x2273badf70bae89866f9a41ce5cd66a060dd17d4,1046,700,0,223,8000,9969
108,0x11451a88de6d618321cb568217badd8612e63ca3,7459,0,0,0,2500,9959
109,0x91a317f1f243da7624b2dc6e3c9cbc6216b976c5,2950,0,0,1000,6000,9950
110,0x4e7d7d43ca2ae5a1dd4d8aa4ae8421e0e218622e,5930,0,0,0,4000,9930
111,0x2b73188230e3c45fcf88ea621874776369bcc8d6,5913,0,0,0,4000,9913
112,0xd06fb7c7ac9c18a21e6cea7f442a297f9481c663,1111,0,0,2800,6000,9911
113,0xfa951187d3521e5dbe8d734d9416f965413a0929,5410,0,0,2000,2500,9910
114,0x7ffeddb3e3b6b87d6288a156650c12c231e5844c,3472,0,0,2312,4000,9784
115,0x364da6fc06c67b246086edd0ba5650f420fe10a3,5513,0,0,200,4000,9713
116,0xd214ba23a785294393da4f06d4f0a82676d4ae94,1096,0,0,575,8000,9671
117,0x379946aa9365245ec8ba525776bf66b5fdf5ee0d,3524,1400,0,697,4000,9621
118,0xeb07a7a5ec09d3c9b9acc2d5110c38d58771c104,1302,850,0,1367,6000,9519
119,0x7cd1bd94405334bd7f54c00595dff3fca0f54df4,5472,0,0,0,4000,9472
120,0x5c2c6035434b76abc131d04433380dd5381db9eb,989,0,0,400,8000,9389
121,0xbe6e84b1c09a92e3d2ad257c84d7783255a030e6,2208,600,0,500,6000,9308
122,0x071402f538721d473f56e77189b8c57ec8aba66e,2812,0,0,400,6000,9212
123,0xae74824e9171bdfdde0c2e3be72b77ae27a97255,3283,350,373,1172,4000,9178
124,0x3526568fb16bc29034cbf9f8def9af7ed743fce6,170,0,0,4960,4000,9130
125,0x5122a655b74796fae8f4a4376218e950e53f19cf,3843,1150,0,105,4000,9098
126,0xcb98bb290505feb876a6e9d1072c10413722e3c1,1445,0,0,1650,6000,9095
127,0x4d003a5728465ac4ab3048ef898cba221c80cc6b,7072,0,0,1000,1000,9072
128,0x4773eabc47aa6de55aa7b65d00441dda69d5b388,4205,0,0,800,4000,9005
129,0x4faabd6667e7be0bd64aff02a6717478ca10d8b5,1954,0,0,1000,6000,8954
130,0x3d8dc04e7dfc52028ffefb9417fafcd4e4ca0818,2042,0,0,900,6000,8942
131,0x7c818b5d1cf4fe56e77992f153702b92af6055b1,2612,0,0,300,6000,8912
132,0xe7cdf9238020bcf252f2454e074d260b857a0143,1902,0,0,1000,6000,8902
133,0x61eb9739dfd15df7623a492c9b8f822608483b3c,2878,0,0,0,6000,8878
134,0xaf6e50e52b9c89fdbb573cf2f048b40f881132d2,1968,0,0,900,6000,8868
135,0x3e901c4500d6aa4dbecaf3d889caa2904928b98d,705,1050,0,1056,6000,8811
136,0xff41ef0306ae45f4a83d3845601927a3e57b9f0e,7292,0,0,446,1000,8738
137,0xc054a025f7d824127e9a9bac03bad49035fcb726,382,0,0,320,8000,8702
138,0x98ed3de65a3eaa55dcba3a2e287695b0948092d4,6199,0,0,0,2500,8699
139,0xb1fa926e7b820ed08529f5f14853938523614236,1598,0,0,1064,6000,8662
140,0xf7174bd56541305b18222e88c1f3ab82776993a7,3432,300,0,900,4000,8632
141,0x59cb1cb5dbfcc4190005f38ae9665da4075c0660,4259,0,0,334,4000,8593
142,0xb2749573b742322c82b34640cf691d80acd1d070,582,0,0,0,8000,8582
143,0xd286fa37bc098fd46599c3ebbeb407ac60af047a,5451,0,0,580,2500,8531
144,0x690a2ba134d8d49e07ac5786d6dc02ca735a9633,1993,0,0,500,6000,8493
145,0x6eee18869e8562ad5a1ddbe076712c20b8dec21b,2175,0,0,300,6000,8475
146,0x2a80b1ba1bcae931cd1996313f9540cefb112051,1191,900,0,3842,2500,8433
147,0x103c152d58b8946c0b2ca7f3286e0e56c2f7a29c,220,0,0,200,8000,8420
148,0x677560d1eaa746ac5654680644829d35934585ad,3417,0,0,1000,4000,8417
149,0x2ccb1eeeef98fdacff2212211a3706bc2c973a09,404,0,0,0,8000,8404
150,0x3c044e3ea8201abd1ee887ae1cd9f0ee9e5e35f4,4032,0,0,340,4000,8372
151,0x779b00a7eb05a66e5db2371cf1b04586ac27bfcc,5851,0,0,0,2500,8351
152,0x4d808870f53a642d5489ed958a82ecd975e621e7,2938,1400,0,0,4000,8338
153,0x0eef71e4b5822f34455b5d5552a579d43ff2cef4,1619,0,0,712,6000,8331
154,0xe6d84cd11da92fb4cc37697386fa5d2d5bdbd4b1,2327,0,0,0,6000,8327
155,0xf390e6882d35b6068f40cd9335989b2b81179242,2208,0,0,110,6000,8318
156,0xee2672aeb588fba1fdc83cf7ad9ff68a473b1cbf,1988,0,0,319,6000,8307
157,0x84705de9c79c49c262817cf905c11d8c7f4ab3ef,278,0,0,0,8000,8278
158,0x382e3eeec3ed2880bcc77c0d7e2d172e01c18a35,5342,0,0,430,2500,8272
159,0x9e1e3857fb2484379858b9daf230379015a7a100,3700,0,0,534,4000,8234
160,0x39f7cc2c7a6f522308c8a75d038f4aa4d7abdd90,1165,0,0,1000,6000,8165
161,0xab194b7a7af12b174fe40d828a40ee5e6dd42418,118,0,0,0,8000,8118
162,0xad0867a794dce05fd8f4c97bcba80841d3be435d,43,0,0,0,8000,8043
163,0xd81de87e17035dae8fdd2e4e1285647a9c31c7c0,727,0,0,1265,6000,7992
164,0xf247b7f6bd43748f8665b9824911ce14799ea519,1855,0,0,0,6000,7855
165,0xf002995e32b71abc2cd90269a5a07150edb72628,5331,0,0,0,2500,7831
166,0xee74363938c9e3093d2de39b23e9744a74689b8b,3829,0,0,0,4000,7829
167,0xba0f9b5d9517d8564018430242413c6c504e94e6,1567,0,0,257,6000,7824
168,0x811affdae69818ca9da330db72165dcacf379088,4832,0,300,163,2500,7795
169,0x31a3056398b09176cdb85206277a4a72e1c7f656,2767,0,0,1000,4000,7767
170,0xa4bd67f6454bb7793b3bcea59e3094471242a307,1223,300,0,229,6000,7752
171,0xda90ae00b36f662ccd8ae1050257a727c67a5ae8,3433,0,0,300,4000,7733
172,0x279929c6633216aded13c8f6c723ba2d6788e156,1128,0,0,500,6000,7628
173,0x70ce3ef631ddd4bdecc55466895db803c3684bff,3369,0,0,250,4000,7619
174,0x745f74a7925d7638dabdea7d06bdeadad12f9a2f,1103,0,0,500,6000,7603
175,0x38ddedb2377c29e1ee3fffcc0efb6bf19bc9dc30,1567,0,0,0,6000,7567
176,0x6a3d22f0677b2333a86bfe96a9f3476466e25d8e,3000,0,0,500,4000,7500
177,0x68634371b197ecc675d0c99462d53c83aff6d15b,3491,0,0,0,4000,7491
178,0x3067990803977f63d7b294b0236eb20a2d0e2655,4343,0,0,600,2500,7443
179,0x647faa4da0e66f4e7bc81cb5043a8e6484d80481,2292,1100,0,0,4000,7392
180,0x15568fea297aa8f2ca1d8ac52798f90468159233,2408,850,0,105,4000,7363
181,0x7718cf2a04e0e7b2cf55ffd29491be7269ec13c0,3903,950,0,0,2500,7353
182,0x406ff6bb69259b4e840d1d00eeb6a8808abc001c,2167,50,0,1119,4000,7336
183,0x6e3ababec4158c3135b904a20f33160b520838f2,2042,900,0,371,4000,7313
184,0x95cbac20c014ac88f76ac8f4da943a53696ce40d,1971,0,0,1313,4000,7284
185,0x4bad621ad05b4afd22236dfd56c463a45c715866,770,900,0,3107,2500,7277
186,0x4b68b5a0cfc1fa1a85f6b3c0db33f546b6cad57c,6242,0,0,0,1000,7242
187,0xa9b1939dd4d20c057baf701885b1bf3c0c6d23ba,2777,0,0,400,4000,7177
188,0xdad19177128fc63b9de5aac7c9afb08ede8830dd,769,0,0,400,6000,7169
189,0xd00888bb26604f83bf9e9205a9cf8e74316e0238,2961,0,0,200,4000,7161
190,0x1be61d546fb4029c993648834db1f881463b4f05,546,0,0,556,6000,7102
191,0xb01e81b78667501e017f570270842ce53b854e3f,929,0,0,172,6000,7101
192,0x6a7944eb538643380b48fee0935d232d46c6b339,2865,0,0,225,4000,7090
193,0x067b7633fe9f6987ecaca2a4b50ea9a46bd4c885,2812,0,0,266,4000,7078
194,0x00ab6b4f02d4a04c753e2f3209717eb06900b72a,955,0,0,110,6000,7065
195,0xabb28af7a784175a76784375190360b30ff4a04f,4540,0,0,0,2500,7040
196,0x8d1dd9af5d4588b83b7a8997a5852f580861c23f,3021,0,0,0,4000,7021
197,0xf842105c186f75cc72205153d339baf172b103a4,2848,150,0,0,4000,6998
198,0x4d645615989e09f92779a6418fbd39b2e263aa19,2974,0,0,0,4000,6974
199,0xe560344f807a59740cd61617b4f19ffd36851bf4,1899,0,0,1000,4000,6899
200,0x11ac3cadeb7f58fee3cb072f002fbce4e5069137,759,0,0,3579,2500,6838
201,0x4934caa063e1ad1379db90fed945f88742fa1a40,403,100,0,300,6000,6803
202,0x45dd1514b3933cf78782cd2233d5127b4ef19388,582,0,0,200,6000,6782
203,0x4251aa321780e356e93577c4fa8c86a9838e15a7,0,750,0,0,6000,6750
204,0x7b1972add376d1455de293c816127015392f3093,6,0,500,6208,0,6714
205,0x39f2c6493b00514abeb237724c7f06f071659cfd,514,0,0,200,6000,6714
206,0x78c6dbf9d7f6c6643df17ea8c6338e71cb18a213,3306,250,0,624,2500,6680
207,0x5ce6aeb2b85e2f3ce2bf1fc15024f3dd121a81eb,2663,0,0,0,4000,6663
208,0xf0df547b76af0fef5f6959a96ec8a026132f236b,3996,150,0,0,2500,6646
209,0xcb0f7b4582b83a57581dbc04e3fab6461a96054c,558,0,0,0,6000,6558
210,0xb518c3e023424d2cb114b05de0829d86126e82d4,1753,800,0,0,4000,6553
211,0xe9d5962e3ae4278e6a3e6356e941e326f11cadd2,358,0,0,156,6000,6514
212,0xb7989e5211135a9f15f2352b499a07fb31d45804,2409,0,0,1604,2500,6513
213,0xc34f7c253047dc8708d275c0195f4f0923916981,4012,0,0,0,2500,6512
214,0x71ab15312fdb43957fc3a943417a493c8b735e66,225,100,0,127,6000,6452
215,0x1a195ee1bf51b7412dcfe853f5442171980b90f6,3941,0,0,0,2500,6441
216,0xe6c401884c19b689127c44660523a6f75e56585e,237,0,0,202,6000,6439
217,0xc51447ad3b831dfc5603b92bfa46a06637250851,3132,0,0,800,2500,6432
218,0xa750da0b3f05431ac22df2b01d2885f7b0cc24cf,819,0,0,1600,4000,6419
219,0xe3ae849dd7efe227454d46373bdfc7e539f6ee66,6366,0,0,0,0,6366
220,0xde43b9042f4d7d520625c9cc42e161c91d643de2,2241,0,0,120,4000,6361
221,0xf229e08dd118cb4b27315ec12fc2031a4dc05097,237,0,0,124,6000,6361
222,0x437dae9da9de16cfb3b43cc6b1531eee47152334,98,0,0,260,6000,6358
223,0x25d8c68bb4690541c4cf79d986964afb60bec708,2027,0,0,300,4000,6327
224,0x832cfa281b8424616c953aee5043e88a33a0a91a,2127,0,0,200,4000,6327
225,0xf670fdbdebb89c4bf9674907a6ff08d9e2c1d791,1819,0,0,502,4000,6321
226,0xa4754b4c6de2464683cf17fe57e8ed805ff32688,2276,0,0,0,4000,6276
227,0x7b07a89f72ebfe598b52f9ae34587bc15072267b,1971,0,0,300,4000,6271
228,0xed315382fd59b1688e4b3b99a367c5639b0acad8,2236,0,0,0,4000,6236
229,0x0abe3a138d48f7e01f96db55e297e3c75048757e,216,0,0,0,6000,6216
230,0x673a05fff17c27f0b88786ea34e7d2f46d125d39,1183,0,0,1028,4000,6211
231,0xf56219d01baa59fbf9756bda772e5a4fb833e4ce,194,0,0,0,6000,6194
232,0x55e72deb10dab4d4644f8a9283e05fb6f9d9c41d,5,0,3666,2516,0,6187
233,0xcba602278422c4138f13c4567a9ff021bcaadea3,185,0,0,0,6000,6185
234,0xf9d9ae3ac784e15eb03df21c078961d9256b7acd,175,0,0,0,6000,6175
235,0xb6e9f1391ef5314b7201f140e70404b62cf39436,164,0,0,0,6000,6164
236,0x184d6d596e2ba3ca1eb4bc7e552d670ce8feee76,2157,0,0,0,4000,6157
237,0x8e2f648437db509f5a62dc29d111b9fda4edd16d,128,0,0,0,6000,6128
238,0x19ba47e96f888b9457a14da2db3a8a705ed10297,17,0,0,103,6000,6120
239,0x0dfee9cdd62c9ee8679fb41c6fca2c029cafac6d,109,0,0,0,6000,6109
240,0x8384d93922c9d9f512ac9d7837f6ebeb5821cbd5,0,100,0,0,6000,6100
241,0x67a0f1a33387d614aba663d303f860d1c5275b39,1586,0,0,500,4000,6086
242,0x7d8d05f8c45699bb979ada66338db16408ece508,82,0,0,0,6000,6082
243,0x67dde272d06b358cc13e8301186d4c982e8b3340,62,0,0,0,6000,6062
244,0x8ca9d80147ca77766982c9be22c15aad44f0371c,33,0,0,0,6000,6033
245,0xe0bd9836393b6a708f6b8e94380f6cc2ebe7f9f2,22,0,0,0,6000,6022
246,0xdf0070360de87de59398ec640175374de330a0d8,1821,800,0,900,2500,6021
247,0xb2fddb2027d163a9a5f81784d94c1b632830c605,20,0,0,0,6000,6020
248,0xbf12f2ffa4b20b74d1a9921c821b8934c376213a,13,0,0,0,6000,6013
249,0xa9b0d33b855cfc1adb1a058ae7b54eb9ec4dca5a,3256,0,0,215,2500,5971
250,0xdeadb83527823002f3e6128735576529553a1266,1956,0,0,0,4000,5956
251,0xb199180a3dcb18d850158a1f1dd162f470d47824,1544,0,0,400,4000,5944
252,0x03092777db2eed0d4ab4f1ecc3aabe698790f79b,1941,0,0,0,4000,5941
253,0x215836b739fea38b5b982cba6087f11c763f5d1c,1930,0,0,0,4000,5930
254,0x8cc75535962fbe084ffb2bfb57ac360320e082cc,1324,0,0,600,4000,5924
255,0xfeec85c46f99a9722636044d5ea0b5dfdd5c5cd7,2860,0,0,500,2500,5860
256,0xaae499f60abc75b49c7f0113439c5da4319fabc3,1784,0,0,0,4000,5784
257,0x5b5fb5639ee079fc1992c4f2898b3eb653ccfe20,1875,1150,0,227,2500,5752
258,0x77a85fb4823344553b9906dd4b5505c5e50d9969,3171,0,0,0,2500,5671
259,0x888028322b5473b4c2ea70cb89e26c1d83be7f3e,1573,600,600,1885,1000,5658
260,0x412d4613b8cb83f78de1e4f1308bf606b3f758b7,2963,0,0,175,2500,5638
261,0x51aa8786569f3a628e6968520dde5dcc47248963,1396,0,0,223,4000,5619
262,0x98d6a93fcfe05b72f1233b8f1d809637e42dfa65,1097,0,0,499,4000,5596
263,0x6ea68f8c8959d2b61f499b044a4871c4d7df0b0f,512,900,0,160,4000,5572
264,0xf87cbde3cd8baf0e3ade7b824bd0abd878aea16b,2749,0,0,300,2500,5549
265,0xb7e66155379a4fc882d066e3e512db8bf43e1979,1546,0,0,0,4000,5546
266,0xcd62d9c117f7068150810dd97c6d11c5251a8d01,1335,0,0,184,4000,5519
267,0x96f47cbb5fb486248447f4195490bbe27d865cf2,4294,0,0,200,1000,5494
268,0xc3a649c987f45e1524c9e01420b3ae7e513c019a,868,0,0,591,4000,5459
269,0x959de51d293aa775cfad14976148bd6c9fff47ea,829,0,0,627,4000,5456
270,0xb70f05c4e9c5b438917bd8ac8825de51cfa6a207,1434,0,0,0,4000,5434
271,0x28a520f2049f65166e6bb21571513429841b3914,2912,0,0,0,2500,5412
272,0x28cfa12606ca4f37af1c8700b7b3918a361205b9,991,100,0,305,4000,5396
273,0x7704cfa2f3df27a21c7a60fd2eb70fb9c81ff76d,1381,0,0,0,4000,5381
274,0x4f5be5965b760891523246a668cf86fd3648d19c,1167,0,0,200,4000,5367
275,0x7ff0b812964dee4b3065d51650fdd57dbd65d092,135,700,0,510,4000,5345
276,0x62ce5c4e0c7b09da57c8dde98b405401d2422c02,894,400,0,0,4000,5294
277,0xcd2e60153e8aef537fbd78a4d351aac3f16b63bd,936,200,140,0,4000,5276
278,0x6b1aac888aa5a26f69e110960c5fb1e09d4e0d2b,1126,100,0,0,4000,5226
279,0x8a9992acec31760d4fd5e35b01271326a671d6b9,1000,0,0,200,4000,5200
280,0x5c991742eba528834f2a4776fc69dc6e7232e5f0,1989,0,200,500,2500,5189
281,0xf390755b40535e2f08059ef571b301bcdcc0907c,4166,0,0,0,1000,5166
282,0xa8637069de6f667158fa2ac41a6d12feac9c9d5c,981,0,0,173,4000,5154
283,0x13e9363758de918ee531482a7b19e615aeede423,2518,1150,0,475,1000,5143
284,0x2be70b7789c51979e98112b32a554b93a213dbe4,1857,400,0,350,2500,5107
285,0xf5569ef6d42e44d5e8f02e893a931600c418ac7a,505,0,0,600,4000,5105
286,0x8e75e8ecd2b383d357877e5fb21c20db5cddd6b8,1093,0,0,0,4000,5093
287,0x758387a5dbd9d7ad61937b1abfb43e1ff2400332,637,0,0,450,4000,5087
288,0xea9955efcacd10a2ae72287a959c53cc311dbd8a,448,300,0,337,4000,5085
289,0xa876f7d1b5c29cc8a86674987e80505e9de3d29f,2393,900,0,790,1000,5083
290,0xd1333b41d5851eb2c229ee3acf8b3afea2c6a486,2581,0,0,0,2500,5081
291,0x8e0535e9d69feab9a5403bc827084abfc9304ab0,2572,0,0,0,2500,5072
292,0x9a88e2361db0db4b2d81fb3b8da3f9e383fb8a5c,4040,0,0,0,1000,5040
293,0xa67a51059127db067961c52b2141ae9ed3022c5b,989,0,0,0,4000,4989
294,0x7055e75dfdb8b22a2542f609ec2eae0a53374867,251,400,0,287,4000,4938
295,0x725865e744b6269dc31f2f8550b6b644c20fd1d8,350,0,0,575,4000,4925
296,0xa9d0e9bb98ac9c0f9fc41df7e270b3e0750e1278,4910,0,0,0,0,4910
297,0x9cba57def0b8d2f2b356582178e09043ae3e631b,693,0,0,212,4000,4905
298,0x3dfd5564566e20f36338a530d1426e47298e8091,1772,50,0,546,2500,4868
299,0xd9d9c43ae86e3cb518a705f39571940f816caea5,444,0,0,392,4000,4836
300,0x1f571b695eec7d01277f743487264060ca16653c,3835,0,0,0,1000,4835
301,0x321c8e1dd1077cd70b3058eb8fd9298d507ef054,1014,1050,0,250,2500,4814
302,0x13c4028cd9e9554784cf699bd5566c82e4b7f5d4,3808,0,0,0,1000,4808
303,0x61753567d64c18b7f0836149d35e4fef8d49b82c,1892,300,0,115,2500,4807
304,0x4277ca38084f942741748bbfb84369397d99baca,545,0,0,250,4000,4795
305,0x58c4876febe21bddf5016fc65a593ce65f397aa4,760,0,0,0,4000,4760
306,0xda9d52744bce43b6cc0fbdb1d74ac90f0a1398da,4750,0,0,0,0,4750
307,0xefb168465c39d612c46872b6bc7d1f171e006028,1940,300,0,0,2500,4740
308,0x410bd673d011704ee5330f97e262e36c0da57619,2027,0,0,210,2500,4737
309,0x19b3537851e4da81e17f0c390054f24f28b2d75e,1234,0,0,1000,2500,4734
310,0xb9c23a06681dd13ef6e4a57a5a6e3e8fa458521a,133,600,0,0,4000,4733
311,0x08af2be6e1e92d6f612106dffff474bb1b482e79,367,0,0,304,4000,4671
312,0x4a1131863118ddc6cff098e074af9481e58ce93d,421,100,0,142,4000,4663
313,0xd2e6fd16e0debe8785db82ab6806dbab0ffcaa26,1699,200,0,253,2500,4652
314,0xe85e5955422fdb5943d258eaa336823c30a9afd7,2122,0,0,0,2500,4622
315,0xc368fb970bb9426f3def1a78e0f98458c797dd72,161,300,0,160,4000,4621
316,0x7285beb4375858a1f9edef822606ffa5df41ac13,1796,0,0,300,2500,4596
317,0x17d05c8f7f495a652fe506595ece459bfdf3ee83,211,0,0,350,4000,4561
318,0x49094d4a1c5a032b7adf49687689155b865d3719,557,0,0,0,4000,4557
319,0x8645b1811a0e582dcd2a3cf42e3dc89a6cd388c6,273,100,0,180,4000,4553
320,0x8f63828687b27e6c82fea3517d2fa9a157d3f5ac,552,0,0,0,4000,4552
321,0xbae24c3227779b641dc55cbe0dd2aafdde9e3133,295,0,0,250,4000,4545
322,0xaf62aeb6e80573ad5e2aae447500f33705f1e991,541,0,0,0,4000,4541
323,0x69d9186c911f23dde167186e11dbf73ae1d21422,528,0,0,0,4000,4528
324,0x866670d6e5c2d9791c16458b3119012fc186e763,100,200,0,199,4000,4499
325,0xf6427955be361fee70d1923b96737c1b5ec3f2b2,291,0,0,200,4000,4491
326,0xf2139f026db96c7924ce79cab1ec0e146686e7e0,476,0,0,0,4000,4476
327,0x5f61ed69b501feb8c21130f414c43d9ec61c4c02,3183,0,0,1284,0,4467
328,0xd5f217010b116653fcabf4611ec00db7b1e0914d,284,0,0,160,4000,4444
329,0x315e820f1db8c5743010c23c389e4daaf66d2219,439,0,0,0,4000,4439
330,0x7dc03bfb85f20c0559bcb1d1ee8696321776fba5,262,0,0,166,4000,4428
331,0x60aa8a09b6144117a3015ef62d8bf8baad5f3bb0,191,0,0,234,4000,4425
332,0xc2582c1300ccbe4e52bfc31c4d49be107a6fb747,257,0,0,150,4000,4407
333,0x71297f02ab9971c99abd67c3f18e87b0ef6691cb,221,0,0,180,4000,4401
334,0x85424527f562ace00e055589e15048dd477cc564,401,0,0,0,4000,4401
335,0x9ade0002fe2f0c2620e7804827dcdd48b2949f01,373,0,0,0,4000,4373
336,0xa086ee8af7d931f46ca0765f5b49fa395c74950d,1870,0,0,0,2500,4370
337,0x0264bb36b78f747666d2c4257844abe299aae57a,1868,0,0,0,2500,4368
338,0xde5fee9652ab1656ffe9fab293da0274ba3f0ca8,359,0,0,0,4000,4359
339,0x829bacf4cc05418cef0e194e23fa9b4548f9e541,340,0,0,0,4000,4340
340,0x880b1876447ca0c9bcc644dfab6eaaf983a9daa4,1709,0,0,129,2500,4338
341,0xb90d0a001c06674538e6f04d1766938f3c3c1aed,335,0,0,0,4000,4335
342,0x867e7800c5d6e7d391682a425f307284aa8ee316,111,0,0,220,4000,4331
343,0x1d91db52e49b608e7cff0389f04fa466b15a24b5,323,0,0,0,4000,4323
344,0x9e75aa8da215804fa82c8c6b5f24bbb7ff069541,127,0,0,195,4000,4322
345,0xa6e584c610c8eb7f8fa77294c23a07fef5f34f8d,69,0,0,250,4000,4319
346,0x4c13361c4e04206f41ec81b506d1d2df70ab5751,1405,0,0,400,2500,4305
347,0x57481ab7d4bdb94dade9d97646f883984d198bae,297,0,0,0,4000,4297
348,0xc7feaf38594e78ad08c795b82caf61e86f36e0c7,180,0,0,101,4000,4281
349,0xbd2bd8fdfa692f8ad38acca070de020476809db4,1778,0,0,0,2500,4278
350,0xe70e8cbd10a932e3a7eb27705749c9287e3d884a,1584,0,0,192,2500,4276
351,0x5b0f44082743e72b440ceb6eb530ac83e95eba25,275,0,0,0,4000,4275
352,0x7dfb3dea1935c677c041e2f6982b9eeec937502b,20,0,0,252,4000,4272
353,0xd91523f9fc871c8f6e57598ff3d862e7281c910c,166,0,0,101,4000,4267
354,0x24c6b71646da84dbe7851d6a79e3653f873e9b4a,212,0,0,0,4000,4212
355,0x78d39777843129f3a73752916a7d2622319519bf,206,0,0,0,4000,4206
356,0x0e2149e503eac0936f2880915a5f8a9936f6bd14,0,200,0,0,4000,4200
357,0x972e633f5f6f62d1f2a13977f113941fcb3b606b,0,0,0,200,4000,4200
358,0x04dc9e10ae8bfff26a553edeacfa51acc57291ca,184,0,0,0,4000,4184
359,0x4bf97a55f26343123260cc989402ad8ea9f43846,1674,0,0,0,2500,4174
360,0x3988dff5d29499038c5d5124a770c6557c2c146a,166,0,0,0,4000,4166
361,0xa122c97d15e338e7da6c97e3154f787b4d31d893,143,0,0,0,4000,4143
362,0xa789a7ccf50a346250d516571c96588078b9d205,89,50,0,0,4000,4139
363,0xcb77a8d5e409c3371adffba18a668f619b7fed78,132,0,0,0,4000,4132
364,0xcea1ff53d1d1fe7b68de007cbd193e4d4ae58ac3,631,0,0,1000,2500,4131
365,0x771b5ebbec194be726e6193968a59b41f49403a5,1361,0,0,250,2500,4111
366,0x9a58b9a234022c1c8d92b3ff9dfbcdc9cb588aff,107,0,0,0,4000,4107
367,0x66733550e79fb5cb58ac976c84490a391d29bdf0,84,0,0,0,4000,4084
368,0x282b578d26f33ffb236fe493afa36d2b7412157b,82,0,0,0,4000,4082
369,0x56b1f254a66aa48767c3a59be167eef01c81039b,1118,250,0,212,2500,4080
370,0xd6988db071877f91ee3edcf73b94fbd9e35fdb81,80,0,0,0,4000,4080
371,0x84b1172dd411adc84a16dcd161f21cc1b0168ff7,74,0,0,0,4000,4074
372,0x0bda5ffa68972ae3586102def7f97083b6ab54a3,64,0,0,0,4000,4064
373,0x3ac86ac6d1ef70889a84198103278bceb049fce3,1557,0,0,0,2500,4057
374,0xf52c0a216dfc67313338c703e69342511f62ebc6,51,0,0,0,4000,4051
375,0xe9690567bd3851c6fcf6b51839ff027f1743d8c3,45,0,0,0,4000,4045
376,0xd4c85d3901158860da7632726e10f08d9991377d,41,0,0,0,4000,4041
377,0xdfeac721c03179a91df843f1ffb823f64b4bd332,30,0,0,0,4000,4030
378,0x097cd951f746c9182c8ab68f51787054e76ddeb7,27,0,0,0,4000,4027
379,0xd0c68be2da85c07442295f319da54c112fb2ce8d,26,0,0,0,4000,4026
380,0x5ace364de66dafdb8e879f8743a859d27c6966fb,19,0,0,0,4000,4019
381,0xb0012c49cf4c4669d424063b682791672b5d2e0b,16,0,0,0,4000,4016
382,0x1781facf9e7098f64eb5c5ba503fbe3238115be9,16,0,0,0,4000,4016
383,0xb306e1ac79bfb44f6af18856a15202f0ae94da85,15,0,0,0,4000,4015
384,0xe03a5db3d201b060e2900c8a2eab29e704676d0a,167,0,0,3800,0,3967
385,0x3a46a6df61f7c10e4c1079a093bfe9113b2ee21b,965,0,0,500,2500,3965
386,0xa8232a38f2935e8ee543718fe163c2a5a2b868c8,960,50,0,400,2500,3910
387,0x9169c186b65a246ec627a9a453276540412f6278,3607,300,0,0,0,3907
388,0x13d761db77e560043c61bd7549f02c5fc3cb9fc0,1133,0,0,242,2500,3875
389,0x35c09a5f7c7630a7be39d6f7479ba120b399b21a,441,750,0,180,2500,3871
390,0x656e52dbe475ccaa17eade77dd4665b9c6773c6f,1336,0,0,0,2500,3836
391,0x77255ded09254c82cf4d203c278015405ea96c20,1084,0,0,200,2500,3784
392,0x99e76e643ff83dcf151093220fbf91a1c70104d0,1281,0,0,0,2500,3781
393,0xdbd0a3b1391c651ace054c44f5f507bad8bb30a9,1266,0,0,0,2500,3766
394,0xdcf85d223489c187d280aa83723a171ad2e4a474,1103,0,0,152,2500,3755
395,0xa78aea859a428b1e40739d5b07a78614d3f7ab18,1002,250,0,0,2500,3752
396,0x5a267648184fc3aa949a85ba489d490dc039f2d6,1049,0,0,200,2500,3749
397,0xfab66358a111696c1c53ca5db3290e4241b1231d,1241,0,0,0,2500,3741
398,0xf91f307b84a188f2687080b54a219e92f400283c,280,950,0,0,2500,3730
399,0x763e1d60ed5d57195383cfb14a5e56925af76063,657,550,0,0,2500,3707
400,0x2d97188d8b07148130de640fb464da791f2fa72b,517,0,0,621,2500,3638
401,0xeb890431437a84ddc3115726cb76b587212dde8b,1105,0,0,0,2500,3605
402,0xca27a5872bec32b06e93244d9d723c69e2d2f45c,1096,0,0,0,2500,3596
403,0x9bc5f114622cc2cd0509e245c9f32633ce48149e,2233,0,0,354,1000,3587
404,0x30b5bb3936f15d4001b05ef3c5bf04d46214f639,677,0,0,400,2500,3577
405,0x83faeaa32b65da3489f3ae8d4bb014951ee3f8db,1063,0,0,0,2500,3563
406,0x34301ef4f9b295ea011cbbe7d60c9a21eb7a98a4,1057,0,0,0,2500,3557
407,0xdfa30b17f2e2451e2054bf11262df5b1fd3d2543,642,0,0,400,2500,3542
408,0x9528240cbab5e2fab40248f4907e8696b3f23fd6,252,550,0,211,2500,3513
409,0x987a8f3a0a7ad3b6a4b943c0411f4021b22a24fe,3007,0,0,500,0,3507
410,0xa310721fbd2c38c5c62bf43f5c83612d09fa02a0,0,3500,0,0,0,3500
411,0xd1261daa88f53de7d9c935715e2d04fb756cd3c2,591,400,0,0,2500,3491
412,0x8740a43d6b64ba8f4710e50fdc4569e53522b389,660,150,0,174,2500,3484
413,0x653734faed8b6caf6aba1abba014033bb688d421,783,0,0,200,2500,3483
414,0xe13a389a0dd6dc13d3901725a0fc224822738088,1870,0,0,601,1000,3471
415,0xf3eab93aad4d9fee50a0b3072a56b9a1041859ba,585,0,0,356,2500,3441
416,0x4ba926ce1637b6b9179175db190e288579d8edfe,602,150,0,188,2500,3440
417,0xddc4980193cf5f607e7e9a02970ff4e607881b1b,939,0,0,0,2500,3439
418,0x98ea696fd1932f013136641963b3f8d83e2b52cd,127,550,0,250,2500,3427
419,0x7ccea6732ab9ca328e6c565ea327763150460fee,2291,0,0,128,1000,3419
420,0xa5bb63bb61b1e213377c431fafb0b44f69a26fba,9,1250,0,2153,0,3412
421,0x6c3918364a8612d79d3d25bb4a4ac54ea9099e0b,910,0,0,0,2500,3410
422,0x5be19b55ae5d97c1d81da9cb7e3c4e963863b6f6,700,0,0,200,2500,3400
423,0xa2e8492a07de0d505f8bb76b2a8758087c099be9,887,0,0,0,2500,3387
424,0x9d8c18f7dd836049343c41341fd1edf5d9ab760b,885,0,0,0,2500,3385
425,0x26cd6bef64943680e52f62ff58e93831cd785333,881,0,0,0,2500,3381
426,0x41c78684c1c25fa720866d856438c06cf1bc6e83,873,0,0,0,2500,3373
427,0x329108220c4da3a789f3fb468d8d04cb89bb747c,372,500,0,0,2500,3372
428,0xf5e9fd385bffa6cde887dc6097036e8e4c2c717c,516,350,0,0,2500,3366
429,0xc2f41fdd95ead46520365b3b63b88d207a310fec,194,250,0,418,2500,3362
430,0x97b4fc65a7878d00a1741f06dc7a49c8d421c520,716,0,0,141,2500,3357
431,0xa26d545ba98d49342ff53b1c5a0b6e5ec00d2b71,480,0,0,335,2500,3315
432,0x6a7f6773f574c839e867127e9ffe5243732446b2,2284,0,0,0,1000,3284
433,0xae4a4e47e5120bca36da2faf0c24aaf883b77cc6,769,0,0,0,2500,3269
434,0x610df1bca040b0e6d8710ad623c399e1d593f14b,219,550,0,0,2500,3269
435,0x2a69d12f42ebc78e40ff656c7cdc842ae4404c52,758,0,0,0,2500,3258
436,0x258cf235c6a45e540e7ab8512904027ff73ba63a,756,0,0,0,2500,3256
437,0x404581fa706e4e0d649a40ea503f9bcee3d2d76c,545,0,0,200,2500,3245
438,0x62f71257c349c3f091bdae1fa0115c11eb950a1f,726,0,0,0,2500,3226
439,0x9d68ff675ca008e43929cd1e160e1d6df38137ec,674,50,0,0,2500,3224
440,0xd4235db8009f376e70e2f53aa66f0a0ee6b8bf4e,723,0,0,0,2500,3223
441,0x6e4014e545adc042871cf185b330c1e06225e69e,427,0,0,272,2500,3199
442,0xeeb9ebb2d538cf972b5cfe248523b4bffb4297d7,398,0,0,300,2500,3198
443,0xc04b3aedde2939406f0ff6df57594727b3fc67a6,681,0,0,0,2500,3181
444,0xdd6403a539c741e34c8b5bc774a39f5601c48890,670,0,0,0,2500,3170
445,0x10dd8045135a07eff38032f068453db382948d52,666,0,0,0,2500,3166
446,0x21e52c912c9dea987351978333d2ee1e700c147d,1045,0,0,1111,1000,3156
447,0xd60ad36bd289cfb89340804493c200fd04154547,445,0,0,200,2500,3145
448,0x639c93e5511462acd49628b4edc9bed71b0c8361,183,450,0,0,2500,3133
449,0x6444ff67a60e4d612f47236d7421e46bc2cdc69c,2119,0,0,0,1000,3119
450,0x1dd338e033e04b2756b01046fb47ac1fa6e212cc,209,400,0,0,2500,3109
451,0x5114ed5510ebdecbae3c8486694ad560932194f7,595,0,0,0,2500,3095
452,0x4f4119c34a1afc9ec7b4ebbb157f68383226a6ac,310,0,0,275,2500,3085
453,0xcb63c10bfcbe41795f238c1e4e5467efbf994e36,403,0,0,152,2500,3055
454,0x231382e56211951f1f470b5cfd02fde6bf70f0e2,553,0,0,0,2500,3053
455,0x2bef883f17a655ee11e47be97fe898ab261b6147,547,0,0,0,2500,3047
456,0x80ae55432037181c5ec2bd13d2eada87de8ca665,2043,0,0,0,1000,3043
457,0xf827ccf43ec0f70ccba8767a0a42cda45ddf3b99,538,0,0,0,2500,3038
458,0xfcd5a7fa2424704cb863de4bdec1bb98a3287285,162,0,0,375,2500,3037
459,0x9526a1196d23fe643802d4e50b49586dfc51e153,2035,0,0,0,1000,3035
460,0x124093f6d13677aeb818a0886b65ed891dc701c2,235,0,0,289,2500,3024
461,0x84327cb726d0b63c7c46a713e16ad7b736439efc,123,0,0,400,2500,3023
462,0x24d6702b4cda74d4300cb70877cacff8a5740177,261,0,0,250,2500,3011
463,0xe9e9206b598f6fc95e006684fe432f100e876110,301,0,0,200,2500,3001
464,0x27fb01ed7067cb7f9bb3556fd4ef5f2e3435f1b9,1996,0,0,0,1000,2996
465,0x997a5e0b87eaaa7fc3ec09e9986fdd22b31d61b6,280,0,0,200,2500,2980
466,0x6f3fdce9ce6e385cf25e04adcd884d094fd0cc37,1571,50,0,327,1000,2948
467,0xebaadb04c946562a26daf56f12503cd03234d8dd,286,0,0,160,2500,2946
468,0xd7aab833fafa910447cf763938bc30e7b4e28f58,1694,0,0,245,1000,2939
469,0x8caeae3b3b7e23f5542d1f4c4e2e6f1d61155738,233,0,0,200,2500,2933
470,0x2ffe2aa4ee05dc17208c291be28a8562b72cb516,411,0,0,0,2500,2911
471,0xf918ff4a55884c33f6df32be08e25224278fd351,405,0,0,0,2500,2905
472,0xac9864abe1dacb10d3a914d90d4072a2e927bc2d,0,400,0,0,2500,2900
473,0xbb6559b0fe6636c42f4591259994e586d6980d07,0,400,0,0,2500,2900
474,0xddc9712a0c5f3d9c0690f0bd0900514f35dbffda,394,0,0,0,2500,2894
475,0xa86c291bca9569dd03ae55c61167d44bb81c25d6,343,50,0,0,2500,2893
476,0x4b8fa83d60cc911fad5f1e2de46294f4da96bc12,267,0,0,120,2500,2887
477,0xdf3178d24fa9a2407cea220c0cbb316f419edfff,117,0,0,250,2500,2867
478,0x882d64adc68fbbe126905b658c6f1fbb0ed49b92,356,0,0,0,2500,2856
479,0x0899eb3e9242f36be0dbe617506fa6560f5a5dd1,306,50,0,0,2500,2856
480,0xb5a7b0dd4cc17d2759ff24ca633bd41b6a9b2fd0,355,0,0,0,2500,2855
481,0x5abdc81f70204e40fad4cf8ae21c2de484a82f6e,80,0,0,267,2500,2847
482,0xb116ad4d2329599f487e7017ffafede4ed03a4c4,339,0,0,0,2500,2839
483,0xa6e2006350e1efd42a166c6e5d04214027e4b195,327,0,0,0,2500,2827
484,0xfe867550e9b72fcd761f16cd645371988239c8c7,162,0,0,163,2500,2825
485,0xeb39c9d420b859c335a8b8458d0693b3c8cb58f2,176,0,0,148,2500,2824
486,0x4062b0d6738ccfe31b0d25eb6b77b84c3a0f367e,317,0,0,0,2500,2817
487,0x2ce29d6819d6059639dcac1c95c53c4e047928f2,161,0,0,147,2500,2808
488,0xbcc224605383cb72dc603b1e3b4f4678b371c4dc,117,0,0,185,2500,2802
489,0x7cb0d50049ecbf37b3f529e6d48ee39d124c8f30,47,0,0,252,2500,2799
490,0xbf696ad8a4bb40da24f89b131121a58b487914de,1438,350,0,0,1000,2788
491,0x89cc5ee6545349f829a4bb5132f7d7f078199236,1786,0,0,0,1000,2786
492,0x49c455aaef694541d943407e12bf6aaaa27a1fb8,117,0,0,168,2500,2785
493,0x730370447eb0c363fa9cd2cbcedbd27e3bd32edd,280,0,0,0,2500,2780
494,0xe453f235884081b42126690aa2020d995040b1a8,271,0,0,0,2500,2771
495,0xb68c3302d0a317e4bf74a804a9988676b336a353,263,0,0,0,2500,2763
496,0x3656a0a286eeb1dde4afc33864441e2ec8dd944f,262,0,0,0,2500,2762
497,0xcbcf5b2cd7ab1f23870866aedb2698390a1e068b,259,0,0,0,2500,2759
498,0x28b4d5fe28fe242b6fe22bcdcd5d3790b8d67277,408,450,0,900,1000,2758
499,0xc46acd984536f2ca378fd6c64008473bb0f83553,106,150,0,0,2500,2756
500,0x55099339b9ccb397e7e4ac515cc5d19047ea882b,255,0,0,0,2500,2755
501,0xa2abcbcdbeed806bbfc31cfe9db4544d71d20a43,114,0,0,140,2500,2754
502,0x774e059b616e0345350533706fe38b9ca9768598,254,0,0,0,2500,2754
503,0x94a465183ff9a939295d3c8cc09b5ca27a63fb9c,253,0,0,0,2500,2753
504,0x929d3fe677347e19c4f9c80d6d5abe8106c1af73,122,0,0,125,2500,2747
505,0x9ffd8e89cfb99c2c0cd1665280d846e51d8dd8be,91,0,0,150,2500,2741
506,0xfe40c10abc0ccd86c307ea9b2cd3bb01e25628e4,240,0,0,0,2500,2740
507,0x58ebf2747dcc1b769ee55f009d6f5680c23d0daf,232,0,0,0,2500,2732
508,0xfdef34ff3715704a84ce1df2d26d49cbe8ecfd97,128,0,0,101,2500,2729
509,0x983640527d989ee2b0c05b244242344a4ebe7154,115,0,0,113,2500,2728
510,0x7d117cb5c27b31e54c47accfcb489e6ee66f83e7,90,0,0,138,2500,2728
511,0xc4c750ed9d1690b2b5f246ee4319363a1a1fe2cd,227,0,0,0,2500,2727
512,0xe1164c52f73bb4670514ad818c077e1973ed3e13,223,0,0,0,2500,2723
513,0x95026ec7c670081024a0bf03487d51130cd883a3,223,0,0,0,2500,2723
514,0x19c5bad4354e9a78a1ca0235af29b9eacf54ff2b,215,0,0,0,2500,2715
515,0x001928678c7003bbb767282448e813f9b0d56f75,214,0,0,0,2500,2714
516,0xd5e04351c0d7e86a0d3adedfaceced185dec4e57,13,0,0,1700,1000,2713
517,0x5aad302341638541c9a39a1810d466ff5fb2eecf,211,0,0,0,2500,2711
518,0x596dddbe8123362cfe3afafac888efbb31b0bf91,209,0,0,0,2500,2709
519,0x055262fe92c8fbb4b8578bf9ab5945859a582338,196,0,0,0,2500,2696
520,0x0c93bf0bacf2fb82d83028c19811f8be7c0f3178,188,0,0,0,2500,2688
521,0x00fd4811280e4c2da0867112eb2df005e82e3996,181,0,0,0,2500,2681
522,0x2e95e6d58d7bdf9c79f52bdde239148c302798f7,75,0,0,100,2500,2675
523,0x883c7d034bdb1caf0d905e2d70859f4d71524d00,174,0,0,0,2500,2674
524,0x2673d877f9be6e51120863ed9e1889392523137e,162,0,0,0,2500,2662
525,0x0e74fa977a49b91af6af2338b70073ba1250ae04,153,0,0,0,2500,2653
526,0xb19f19b900027fba2672bf56b680204f625d7a24,152,0,0,0,2500,2652
527,0xd1fe0a6d789697361c479c9e3a2b32cb119363eb,152,0,0,0,2500,2652
528,0x55dbac71d136a8ad02edd815b1e1b9217e4a9e22,151,0,0,0,2500,2651
529,0x353546ab91604aa43ade139ab407af6f4fe3a1ae,149,0,0,0,2500,2649
530,0x5531ad71dc8a9b63264266493df8b74c4d12f302,140,0,0,0,2500,2640
531,0x382920dc26179bcd92b26669f518986d3838c81f,138,0,0,0,2500,2638
532,0x393d2fb1fcac3b41bddcb7faab4803766b5e2f9a,135,0,0,0,2500,2635
533,0xaf879e242b8002bd98f8971885471364a393d52e,134,0,0,0,2500,2634
534,0x6d3cdddbdb689b50098273611615f4c17c3a4144,128,0,0,0,2500,2628
535,0xb6b37f580eec1e9c5a599b24edc743c2ca325a37,126,0,0,0,2500,2626
536,0x7a5ef27ea3919b8ae414151c35fa53cb35a49499,124,0,0,0,2500,2624
537,0x3ebebe0a0cf92c33594f5948e7ea654e6c10ba52,120,0,0,0,2500,2620
538,0x0a0bdcff68ab1963c2cc39faff0d69d2764adeeb,118,0,0,0,2500,2618
539,0x3c27d4d81f33d3695a4198fee1668d052ba91ae6,117,0,0,0,2500,2617
540,0xaeedeedd4c8727b2025f7f7bf995c5b55d6b93a8,117,0,0,0,2500,2617
541,0x431d0fc06498dc8d4ee48264f07c8166603ac173,108,0,0,0,2500,2608
542,0xfc2edfc9d947f08f6910465ad1b686b4c641d6ea,1606,0,0,0,1000,2606
543,0xcaab166550f42a316a71ec74eda849892900887f,103,0,0,0,2500,2603
544,0xb5b8f83319c5ac094f9df39383da611c1c453e8b,103,0,0,0,2500,2603
545,0xa7f25ffbfa09ea701a4bbde2e3ec1b8e670f6c10,100,0,0,0,2500,2600
546,0x07b2cb98d91b14c9d7dc979d81597f8bdd979406,98,0,0,0,2500,2598
547,0xc186b1c2e41a676132babf94f894f8e4bf2d69e8,96,0,0,0,2500,2596
548,0x7b71d4e1dda649c6b70f46b74ad974e0b2777a9e,95,0,0,0,2500,2595
549,0xb3326ae76c7f67e1e21f1bd2a27fd1df1594acc4,88,0,0,0,2500,2588
550,0xb4d09d88d0a4b9eb1ab591191091f3bb374db8b5,84,0,0,0,2500,2584
551,0x4c1492c9018eead5cc27c442b774a33950fd0b16,83,0,0,0,2500,2583
552,0xa0825f3787a4a2625ea43780302fe07846c2c6a8,75,0,0,0,2500,2575
553,0x99a0e1c93e7375b1d197bcca720292afa381b4e5,72,0,0,0,2500,2572
554,0x24fc45a66a1b6687c05c4bf1537e233d43a44960,70,0,0,0,2500,2570
555,0xdd4d50c189ca9c3dd3d41bba9e6b0a9bb1df9107,68,0,0,0,2500,2568
556,0x37f879d7c4a23778b252fad5194717b924f8c97d,64,0,0,0,2500,2564
557,0x9e7bde941d281bdfcae93d02697c67f52da876c8,64,0,0,0,2500,2564
558,0x3db9b6fd1594b8ecb8093823c44d5222488f878d,1562,0,0,0,1000,2562
559,0xb69f990465421d2d3cad336eb70cf1609b0c2157,62,0,0,0,2500,2562
560,0x679edcb049ed83b46d4efb3f6cf43a6e0e92a0fe,59,0,0,0,2500,2559
561,0xea23a8b8afaf872aab0361c0a708f0b542bf774c,59,0,0,0,2500,2559
562,0xa32a9374ea1db25859d48af41f3bfcb90efed9cf,59,0,0,0,2500,2559
563,0x86e987c1207df5ebd6d1bc4543e25987cd20efbc,58,0,0,0,2500,2558
564,0x1a9374d0c0d3260cc7e5d8bdfa315a2f2dfad9dd,57,0,0,0,2500,2557
565,0x10f5037f2c2aa5fbcdbac33ae981b2ffae5db71f,56,0,0,0,2500,2556
566,0x04dce2abe30ffab6e9f5b5bf26063e5c1bf14a74,53,0,0,0,2500,2553
567,0x2592a87cf91c1d0bf65570884793e621e2fc0374,52,0,0,0,2500,2552
568,0xee2799263736cae59f3ec237bd03190c38f2e6d9,548,1000,0,0,1000,2548
569,0xce7fa26f49ff812f5f2ceb754f205db6d42c3ddb,48,0,0,0,2500,2548
570,0x947b7d38421e2701852246cf18ef6ae19c299bf3,48,0,0,0,2500,2548
571,0x79ec3c567afa0948ade31e4fe0ff524c49a9bdd4,46,0,0,0,2500,2546
572,0x156e6252da59c0f424c4a9812b1189a008f488ba,45,0,0,0,2500,2545
573,0x76cc02a38c05760b4e9b85c3d237053bc6162ad2,41,0,0,0,2500,2541
574,0xfbc6b1d12f92292e67368206435ecd206fd2fe76,34,0,0,0,2500,2534
575,0xd6ec0396bf2eb8c51a7ceb47a2191e43e6a1bd39,1527,0,0,0,1000,2527
576,0x94a7a0ccbbf54e37b154737b8cc1ecb5cc5310bb,27,0,0,0,2500,2527
577,0xa8b4da0e1bcffd8bec0bb77d095253d59d2e404b,27,0,0,0,2500,2527
578,0x798c090331cb7638e55303de093558ed7838df1f,24,0,0,0,2500,2524
579,0x23af00c325ce769daf1eed5d6c4290eb510b99d0,19,0,0,0,2500,2519
580,0xda888cdca21fee73cb84fef8be562ea6d96d514f,19,0,0,0,2500,2519
581,0x74b5e61e9feabefdcdacf20fd2d1f30502e80601,18,0,0,0,2500,2518
582,0x04b72712f55a2c675fed223b0ba1abbe39eb3424,17,0,0,0,2500,2517
583,0xa99dbafac39777caa24434f8790771a3952542ff,17,0,0,0,2500,2517
584,0x187022f33b178d17d1369fb0b82115b6415cfdc4,16,0,0,0,2500,2516
585,0x6288d0ea977d682f9a2609fd1e399248721e6838,16,0,0,0,2500,2516
586,0xc8603095a07644610a763996ac78cdfecda92290,13,0,0,0,2500,2513
587,0x74b159e1a5a996bb98fd3858567027a7d9c56055,1511,0,0,0,1000,2511
588,0x7a72db6a96672e68c138a768a3ce242aa65656f0,1187,0,0,323,1000,2510
589,0x4e1a6b0ae80a05b0e429144b58b8c3becb621cd1,7,0,0,0,2500,2507
590,0xdb1d7ae5161f655d0da47903541110402011ae71,3,0,0,0,2500,2503
591,0xdefbffe64156f9b5e854206a62796e08df230948,1616,0,0,850,0,2466
592,0x184ad98dac99fd75bb61e0c0f6bd314824fdd8eb,1266,200,0,0,1000,2466
593,0x8125ef62932875f3dfab6c9b39fa12c087397cb5,1430,0,0,0,1000,2430
594,0x85349b9830b07dae1f490fd920db404e76b671f6,1410,0,0,0,1000,2410
595,0x5f31a3cfd8c37e5875a031bc0720497b7fc51127,2407,0,0,0,0,2407
596,0x7b5d9d35652183b8a19d01eed74e10748a5f1330,1141,250,0,0,1000,2391
597,0x2a2d0bb12dcb80f18fb9fb36ae278aea8cb80aa0,1036,350,0,0,1000,2386
598,0x59ed1efca81c7a01d89f8d71c962bdd509474e92,1386,0,0,0,1000,2386
599,0xaa2c7930e2d3c247f20d6c31ed5fd634101c6097,1980,400,0,0,0,2380
600,0x10b0adb54f73e3433028433c63cd2accbe122bd0,0,0,0,2371,0,2371
601,0xc1abc241e272821d5111e3939d96783f5072e19b,12,0,1920,433,0,2365
602,0xf17150e63cf976b71f7a7ee9a2a457312a95516e,1113,250,0,0,1000,2363
603,0x6368ce2750325f5002587c70c8bc298b4df61eba,1094,0,0,261,1000,2355
604,0x54c07a05213933c8d625fa28bd609701d8f3d694,2006,0,0,250,0,2256
605,0x9865f649666d6180421dc3ac86d750535374ff44,1242,0,0,0,1000,2242
606,0x01f796abdb4bbe7c61fdc7433eb18cea50cf158f,1232,0,0,0,1000,2232
607,0x70ddda43d4f616263b1db0ec672cbd8795db13b1,720,0,0,500,1000,2220
608,0xf834753cd273d1364cb9a4c62324e06a59229190,327,400,0,491,1000,2218
609,0x161ec1b7d8d1269075a99e68ba87af93a69185f7,1200,0,0,0,1000,2200
610,0x528ffbe6d67dcfd46843af70356a45372d0f9dab,1176,0,0,0,1000,2176
611,0xa3a6883355814a9b7cb73bab0511106ea07fce79,28,0,2140,0,0,2168
612,0x496529d7742db67e072e0e1e267e140a6997dcdb,1165,0,0,0,1000,2165
613,0x277adf69e2149e457b4f20067293ca21e5a8dcd0,1154,0,0,0,1000,2154
614,0xf030a89f0d4b348eee972aac42636a7f6aa0e2cf,0,2150,0,0,0,2150
615,0x3ca421fd537b60031b6532c1404a67a518d3a762,672,0,0,471,1000,2143
616,0x318706c62ead7e9337c727980130f1ea43055a0f,1137,0,0,0,1000,2137
617,0x15578c3bd3b5408f13c4ea3965231db691dd02a7,418,400,0,309,1000,2127
618,0xd5d7d6ad51117c664ffdc6592ae51d4867b1697b,1489,250,0,366,0,2105
619,0xfd34af111010579e2320244e8151d89f46682a58,1102,0,0,0,1000,2102
620,0x3325aa69435582b7275a9855de59f0669fd6e4f7,398,100,0,597,1000,2095
621,0xd63271f34526575b9f6c9be421ac6edc49e35364,738,350,0,0,1000,2088
622,0xf000d32e544d27dc69b07d69da7a6ca22560dbf0,987,100,0,0,1000,2087
623,0xdf894c958e51a3827e55acba935f6d8f442692ee,1080,0,0,0,1000,2080
624,0x4443d7add1c6106e355dcf3b52fa0ded6e0e9470,1075,0,0,0,1000,2075
625,0x52e62d8f7d68a986b88a017a950bcc4227b8be53,0,2050,0,0,0,2050
626,0xd3f7388354ed392dab2e71854b0c971a91d32c9a,1042,0,0,0,1000,2042
627,0x95d7b1c035a7992c08138dd1ca017a17c39b0389,1025,0,0,0,1000,2025
628,0xe1c462c008491c2a3cba3b33a291a6d3830bdc6f,823,200,0,0,1000,2023
629,0xaf99c11901b5ff3d373096475f646c8220fb9113,322,0,0,700,1000,2022
630,0x4389338ceaa410098b6bb9ad2cdd5e5e8687fbf7,1014,0,0,0,1000,2014
631,0x8be4eb32a944513b733790b304b0de49e2e461bc,1005,0,0,0,1000,2005
632,0x0b1fd1896a3362b13775f8d82769d27bd5ce6c3c,0,2000,0,0,0,2000
633,0xd948adf4b3a3e0b98f6dbce0905554e7a911a410,367,350,0,266,1000,1983
634,0x81f671ed406843525543796a04345117e11a7d94,344,0,0,630,1000,1974
635,0x4818a96740a24f919692e37fdb4437c8c60766f7,768,0,0,200,1000,1968
636,0xc27377cf0262a212552d7bda3d9f13cfdca536bb,957,0,0,0,1000,1957
637,0xf43972afb092632e18d6cb9d8f036c096b81ccb4,689,0,0,237,1000,1926
638,0x811f0cfcc8ecc33eda95dfadbff060e610d2feab,911,0,0,0,1000,1911
639,0xf983613e535999f727a39322008f9560198d23dd,608,300,0,0,1000,1908
640,0xe7954cf660c6b09eb49341a61f8c2bcc31a82c7b,739,0,0,164,1000,1903
641,0x24c8e2b8f1aa2e6ab4dcf5f3b50d56f3d0bd83e1,637,0,0,250,1000,1887
642,0xf4f5c6760bca134b29d7a33a43572fa813e39140,256,400,0,221,1000,1877
643,0x3eadb55cb2b7c30c6f966a33139b338a3affbdb0,463,0,0,400,1000,1863
644,0x681f7985cfe2cfc84dc7a8647158b2d99aa7ab76,855,0,0,0,1000,1855
645,0x10b602a7575b4feaa8aa19fef49ab973ac47e674,553,300,0,0,1000,1853
646,0x513e8473fc9658c50ea01d4a0d358458b15932c5,0,1850,0,0,0,1850
647,0x59d75ed041dd51a2412e4182ef103e3c0d26ecb6,691,0,0,128,1000,1819
648,0x764cae6ec2d32a8ece0fc4e9ec88339f1000bec6,815,0,0,0,1000,1815
649,0xc51799bb87111796b03ced7d2aa7e29208a27baf,205,400,0,200,1000,1805
650,0xca42c9229fc5c83b915f1377775a16e2da62614a,1239,550,0,0,0,1789
651,0x29501d8b238695c618f8586726a6da78cb9f951b,234,350,0,200,1000,1784
652,0x5702a0e39751ba356b8c5eb89694c99d9f5b5f49,781,0,0,0,1000,1781
653,0xd62226180271500f030834ad54c80769dd21b473,652,0,0,123,1000,1775
654,0x687aacda9356c313f9fe88d1f4a24af7ab8a66da,774,0,0,0,1000,1774
655,0x09535b5c76a7daa3d888b9aff95199aff386afa3,380,0,0,392,1000,1772
656,0xe76f0dc9600746c354a8f14cfda36cc54c38ce57,753,0,0,0,1000,1753
657,0x1b683e480aa2723496af6a6c05264665b838cc92,154,450,0,134,1000,1738
658,0xeec9a9efc4e5b8d89b7eb495c14a2452387ba3f6,1589,0,0,147,0,1736
659,0xd3fc36f8dbba7c3b4783e4dabae9c00bf4f26412,583,0,0,141,1000,1724
660,0x20e17c5d83904d9efeb2cc41d62d91fcbeab55fb,717,0,0,0,1000,1717
661,0xdb08172066c516bf0dd147d5d861a8ca7e703957,716,0,0,0,1000,1716
662,0x9171097118899cd0c59f317106d0d2851454106a,393,0,0,302,1000,1695
663,0x937a8aefb580f381b06349bc4a78efe0448129c8,444,250,0,0,1000,1694
664,0x0234e76d0f5ff7de5d0fd6dd8db2f9a910c87934,533,150,0,0,1000,1683
665,0x9809bd2b01ba6b317a06910f0e5e28319277f023,254,200,0,220,1000,1674
666,0x226b7ed8e2dac7f7c529147833a8eff769fdf232,674,0,0,0,1000,1674
667,0x25e33f8f12858ed166650c45357ab2f87073d463,120,550,0,0,1000,1670
668,0x2dcfd1b86bc5532e1819821cb82d1993822c6c0e,394,0,0,275,1000,1669
669,0x3f40763d97fd844a930f652ed6a8c421cbdba3ad,0,1650,0,0,0,1650
670,0xa17bbc84adde59803d855b26810986d765a30ddd,650,0,0,0,1000,1650
671,0x159c0f8281b7fc7bb99d74cd69ffd4c5eb82464a,646,0,0,0,1000,1646
672,0x0501bf3c62d0c26845ff4438b324e170fc4cbe3a,341,300,0,0,1000,1641
673,0x01dca7a46e1753c51c360085fcb619132c035eb7,429,0,0,180,1000,1609
674,0x22e6e2b94538b8448fa11b377fb42dcce193aab6,601,0,0,1000,0,1601
675,0x918f8505c18244a1bc43cfae11edddbacabebfb5,0,600,0,0,1000,1600
676,0x5a0e03362cbd78553b4196f7e7d9346b37d22407,428,50,0,105,1000,1583
677,0x777f2b01f3c6c4f641ac399211ef1541650c2f07,316,0,0,265,1000,1581
678,0x5c3d0c42dae18357364c1bff59557f44e3c2989d,573,0,0,0,1000,1573
679,0x5d61a9b24911c61d9aa9eacfc9ec74274ddda8d0,570,0,0,0,1000,1570
680,0x4ecfd881eb71bdcc58cbeabbe79f90d435da58b0,215,250,0,103,1000,1568
681,0x3655104eb4ce740a4e83881a02fbeb89b9774b29,565,0,0,0,1000,1565
682,0x3f378717d7044b4d5507b806bcc39aa4fd1efc0a,364,0,0,199,1000,1563
683,0xb63c261890b5647aacbb8e8ddfbb635527d2213c,387,0,0,174,1000,1561
684,0xc1e84f62a263ce0f410076c0bb77849cea7c63b1,559,0,0,0,1000,1559
685,0x75c4423ab39bf08b5c5729cbc17875cecfe4bfb5,553,0,0,0,1000,1553
686,0x1e3839b307f2bb3ed5724e40429d981b01345bd1,452,100,0,0,1000,1552
687,0xc5f84ab08eab6db3a25b1ca7e1d62f4fec5e28d4,267,0,0,272,1000,1539
688,0x9567c7c9d7887adb416948353d675a222b7232f9,530,0,0,0,1000,1530
689,0xbbf7d18b980f3dfd02dc0281719c68b1ae5aeaf9,478,50,0,0,1000,1528
690,0xdbc9b571f9633d35fe94bcb7765f49c56bae1890,527,0,0,0,1000,1527
691,0xbff1a2f422274cb7da1ada4704f2eb0b55297b84,386,0,0,138,1000,1524
692,0x2d12494d890a0ca7905210bf5eeafa5d40f3a345,394,0,0,124,1000,1518
693,0x1c1d70f561929941496180003ea21d23bad53535,388,0,0,125,1000,1513
694,0x32e3d029328bd3e22adf7c8cda99a96931faf2a4,507,0,0,0,1000,1507
695,0xa586473ffa45e6a75830f126eecb62ab85b9a988,166,0,0,339,1000,1505
696,0x649deec2cdbd931137f693c364006dbed9820703,505,0,0,0,1000,1505
697,0x12a4f5ca13b7ea9733fec47fca9ae35af9c762cf,0,0,0,1500,0,1500
698,0x4c729cc75e5ac4aa4e3e953f920bd46790ee25dc,498,0,0,0,1000,1498
699,0x1ec718881694268625e3b21420ded0e949bf868d,497,0,0,0,1000,1497
700,0x512bc483a3a65c7573bd99d7b93ea67ed6d0e6eb,0,0,0,1493,0,1493
701,0xfecc8043f25805a644cb8828419ba997f5a6d25c,290,0,0,200,1000,1490
702,0xa6eb89975ab20fd3ce3e3b0819a4859f3bde5c5b,266,0,0,222,1000,1488
703,0xef0cf9f19b010a3bd73e51b8e268c7fe6a1d66c5,231,250,0,0,1000,1481
704,0xfb783cf6dcceef222d743c8db1050b96b64bf4bb,311,0,0,159,1000,1470
705,0xfc0dc083f3ccf33083a46975dcb909ae3080cfd3,67,250,0,150,1000,1467
706,0x389053f4ebd5ab04f9e20c84e6cee65448ec3d76,462,0,0,0,1000,1462
707,0xb201ed632810922b12a3a17f7abbd4f77c74ce5d,1452,0,0,0,0,1452
708,0xfb956fedaeef442cc643caaf47e921224d1a4008,450,0,0,0,1000,1450
709,0x69c6c423d3c811d60d39967c8bdb1d049385c5fe,250,0,0,200,1000,1450
710,0x40a95ea096930b010272277b42558f2734c06f81,278,0,0,160,1000,1438
711,0xf8c48ce1abd5a6f2822c1090394fe53145032533,435,0,0,0,1000,1435
712,0xb681cbfd6e66c4f385a76dd699b1f045aaae8423,231,0,0,196,1000,1427
713,0x44704e1a55b1cd850164aace9c050afb9927f87d,425,0,0,0,1000,1425
714,0xe4184ee7e32b60f3da90dcce59fbef60a19f11b0,164,0,0,260,1000,1424
715,0x3e5882df582b5f4d573aa8df9e24092228a5d494,81,150,0,184,1000,1415
716,0x90336dca8dce81647309a566a93d1a133f22a93d,187,0,0,222,1000,1409
717,0xc0b9ad9fff8aadcec369e318d69bfe8d7195e0ae,216,0,0,190,1000,1406
718,0xe472d5b8ecea5b9544406eac069311dc7a5081d6,403,0,0,0,1000,1403
719,0xfa21cd545911e45e80a8cbe5466aa811ffaeb938,49,350,0,0,1000,1399
720,0x49277f463e7cac2ece63ffa4abd3b7600cdb1079,133,0,0,264,1000,1397
721,0x0e1fe922250bd9817acea75d002e6342a6433483,255,0,0,140,1000,1395
722,0x810ecc68948dff67a5170d55debaff7bf68caae7,392,0,0,0,1000,1392
723,0x8037d995ee3fdfd2b81b4ef1dbac191f0595eb82,389,0,0,0,1000,1389
724,0xcd7521e73b29b04fff320e23c68927e54e9ab7d9,237,0,0,150,1000,1387
725,0x41766ab8d56b6a8280922aaec475e436f59d70d7,222,0,0,160,1000,1382
726,0x741e312e15d56d9aa5e99dcd276628569577d10b,132,250,0,0,1000,1382
727,0x20291f29e84b62519f6047f36a1983e6a4b0f821,379,0,0,0,1000,1379
728,0x4b5715217bcbcfceacfac95f1a9c14585f608e7b,199,0,0,175,1000,1374
729,0x7d3f2edb2b9869f6e21d94a94ecee598f6a3fc86,1223,150,0,0,0,1373
730,0x45566d0c96e88dda9259955917a8f5ac466f59f4,373,0,0,0,1000,1373
731,0xc1d24ec1879ba26a51faec93ae5dcc5b12021c6d,371,0,0,0,1000,1371
732,0x98d41ea1eff071a2677a3db9e86bb674978353ce,209,0,0,161,1000,1370
733,0xc306dd2b96d27b63f988cf1947a45887738ffe10,361,0,0,0,1000,1361
734,0xc4ee098a5f840c3f94ae533e6e1cf28518d6e630,145,0,0,200,1000,1345
735,0x70147829cf79978bbb3ed44f6141c1a520e14f7c,342,0,0,0,1000,1342
736,0x9b3d34980b00af4d9733032cd63332482be31834,339,0,0,0,1000,1339
737,0x814d60499bd401eca426c86ee9b4167967dff8dd,86,250,0,0,1000,1336
738,0x33de5ae9dddbedd0f80a9cf3836822b90e50d97c,132,200,0,0,1000,1332
739,0x57a0d7ebb013b29a74c7f6517ec3b31eef728bfc,332,0,0,0,1000,1332
740,0x746b46d87543eaf779144c8870888119d6ae0c2a,223,0,0,103,1000,1326
741,0x8a8a70705f37a6a74692fbc3fa5b52385058cb38,321,0,0,0,1000,1321
742,0x0dc346425536f2feb24fdcc346cf38a85ca344de,320,0,0,0,1000,1320
743,0x48c542813d21073052d567061af809f95557050e,316,0,0,0,1000,1316
744,0xe73e7867f60096cb02ef2c641b1cfb62273e0f6f,312,0,0,0,1000,1312
745,0x23ca83e0748f95f412db0013ad20e80e3671ffe1,307,0,0,0,1000,1307
746,0xa7a43ea41522eacdb29e98201e2395df64b9697f,52,50,0,200,1000,1302
747,0xdeb74295385486af495149fdd209c4f11bcca530,301,0,0,0,1000,1301
748,0xaf272cfe7cdcaa8321965bc76a8fd520066d0842,299,0,0,0,1000,1299
749,0xbecdf26cdfe9a764f38d58f8098fcb492b3db65c,298,0,0,0,1000,1298
750,0x8f570e5003b70a88d44c8e7dc94021f93a524ff9,294,0,0,0,1000,1294
751,0x7675a467b86ef5a57fd52d39d54590e3109183af,292,0,0,0,1000,1292
752,0xcdb21df1551d3fa3c8119edde8a09f0a234fa81d,289,0,0,0,1000,1289
753,0x71c312cf303f9b3bd655b6ec8e7b78c661cbfa04,89,0,0,200,1000,1289
754,0xffcf112e3164b88c19a111021e34fc9ddb1690e1,288,0,0,0,1000,1288
755,0x85b5f4f9368e4c9ba7c8061c8f98082f6a522e51,287,0,0,0,1000,1287
756,0xabb66bd842be9d358955fe93861302a4fdde320d,285,0,0,0,1000,1285
757,0x81c505ea6cda0f338ab174360185594ecaf2b009,280,0,0,0,1000,1280
758,0x9b5e60f7b4328a2e3bd0e61d999f180210d33579,174,0,0,105,1000,1279
759,0x372c8959fab20078c27782ff153f682ddf8d0b85,778,0,0,500,0,1278
760,0x179a08c7d0324ae42b4cef36116f512914cefe9e,277,0,0,0,1000,1277
761,0xa7b78218eddbcbb69844e8a611cfd423c47a62e7,267,0,0,0,1000,1267
762,0xf6ade20cd5e5c1419a18dc523cdbb36108628540,265,0,0,0,1000,1265
763,0x682b58b6f8cd90ca999f4bb116ed10a7a1d088de,263,0,0,0,1000,1263
764,0x13a062ca5ccfb05458b9f046faac75de9427a804,123,0,0,140,1000,1263
765,0xe98450910c2601ac6528c16eb4693b72bb3248c9,261,0,0,0,1000,1261
766,0xbc09cac87e3ecb879b0355c87ea7d8f822b2599d,111,150,0,0,1000,1261
767,0x2301795c67576eecfe27b9f7966dec2f73ca0987,259,0,0,0,1000,1259
768,0x681f742c9657655cf36debd9675c5083580e7eb1,150,100,0,0,1000,1250
769,0xe88bfc6b12c68bdf7fb04bba31b5e85b88680c46,250,0,0,0,1000,1250
770,0x99bd39a9799e25015cf3a258f32a07b952e9d3eb,248,0,0,0,1000,1248
771,0x070ac390271ab1c6f218154e09a2bee80ccda05c,238,0,0,0,1000,1238
772,0x127da83c62d97b2a7d9a43196f5f956cac42c314,233,0,0,0,1000,1233
773,0xd82666a97637aecf05d3e795717e8e074a9ffcca,83,0,0,150,1000,1233
774,0x51867bb682047166032c990d75f49389168c73a2,949,0,0,283,0,1232
775,0x987d3382caf7dbcc771783390184cf3370621e79,75,0,0,157,1000,1232
776,0x539c82d5cb886c94dd3e2d76dd5c73936c1cf391,225,0,0,0,1000,1225
777,0xa7d8ced3c1acba8a7f7b8e49aca454a643ca93f6,74,0,0,150,1000,1224
778,0x6d30ff83db59b9079ca04741223a4e7807ef7fdb,221,0,0,0,1000,1221
779,0x0de033abe84278aebd7fc83f4c87a8d3dfa8aa94,214,0,0,0,1000,1214
780,0x12306d9e6872bc8646a8cc02e894e1e76a0cbf9f,214,0,0,0,1000,1214
781,0xe1dd7fae1a4c334de4f374f3ae14c4012e15c8b1,212,0,0,0,1000,1212
782,0xac3cfff33e87f4de0617f932f6421f6d4fac8d0c,206,0,0,0,1000,1206
783,0x0db83bebc09398b38524b082ecd49c658d3c4406,204,0,0,0,1000,1204
784,0x4f63cefaf372dd4dbc297f308e26ed8dc6990a78,203,0,0,0,1000,1203
785,0xacc7180ed89ff3259726c9e1e0e3a9c14c62b96f,203,0,0,0,1000,1203
786,0xd4be01e4ab8e3536f6b7abdb13e94dda17f8c9f0,0,200,0,0,1000,1200
787,0xda7affc27ae1b2cd638e590aedc6464e4c8faac8,200,0,0,0,1000,1200
788,0x90b9aae3de0f5df8d11f51a247ee26dad9aefd4a,200,0,0,0,1000,1200
789,0x05b41dc849615bb44161bdb8121478b5c85e1f39,1196,0,0,0,0,1196
790,0x4b5560f4edf8d2b1a9265f6e6e655278aeab0691,196,0,0,0,1000,1196
791,0x1bc273b388839dfb82532f858a21be527dfc24b5,1069,0,0,125,0,1194
792,0xab6ca2017548a170699890214bfd66583a0c1754,189,0,0,0,1000,1189
793,0xaf7307777829953f5fc27300b28ffe6722addb0c,181,0,0,0,1000,1181
794,0x35f12c7c6ad9f23cc0d9adc2d0f2e7254b03169f,181,0,0,0,1000,1181
795,0x6076f58b9b4ebfb79b04e579a129da6f6ac51f7c,180,0,0,0,1000,1180
796,0xc62d7a3472661da57ca1dc3d3a5c59ce442d8ad1,40,0,0,139,1000,1179
797,0x820f32a392eeadec4cc5f37fbd17efbb6c9aa52f,178,0,0,0,1000,1178
798,0x80258f831f6ad02eff97572226d75c279594412f,176,0,0,0,1000,1176
799,0xf0b726329c877ccf8e743ec2efff25d886cb4393,173,0,0,0,1000,1173
800,0x8e3f0ea8d48c221f71473bb9d22c81ecfc0a1c93,173,0,0,0,1000,1173
801,0x1d41c332deda21791cb843db7b0bf14c38c8cff6,170,0,0,0,1000,1170
802,0x03c8a0ddc887341589bd9284f54cb3bee15fd5c0,167,0,0,0,1000,1167
803,0x3ec99b347585836f7221830530f5442251a880a9,165,0,0,0,1000,1165
804,0x1afae64211dfa6718cd6e9073503206fa628667a,163,0,0,0,1000,1163
805,0xf6f7323f981c504f76d6b22ca8eadd2f5c3dd25e,163,0,0,0,1000,1163
806,0xe1fc8b4c3566f5459923cbfaddc1b7741a997c58,162,0,0,0,1000,1162
807,0x627af8ae713d177103937746cdb208bb4bffbf22,161,0,0,0,1000,1161
808,0x404c1f6c19bf8064c4a6686ae94b360044f27096,59,100,0,0,1000,1159
809,0x9f3207d1aa1505952b112e343dc37ed78a0465c4,157,0,0,0,1000,1157
810,0x522e13d916fbef31ec0bd25f93cab93f01f6e434,0,1150,0,0,0,1150
811,0x18a04f895d8eecd474ed78fdf43fa1894949367a,144,0,0,0,1000,1144
812,0xad9415b6ca679fe9cc6734ee310a854c77132c67,140,0,0,0,1000,1140
813,0x7d633164881f60db65665c6f5177a82af8a48a49,140,0,0,0,1000,1140
814,0xca8b656b5032ca9dc43b0c160cf1c5f5f218a658,138,0,0,0,1000,1138
815,0x095452510738122b3e1234d9fd82e26f24b636a4,137,0,0,0,1000,1137
816,0x470bc36888d46b6b021e56c0be3162f9dbaabb1f,1135,0,0,0,0,1135
817,0x712a8bee2609269c12763554904b818f937dd285,32,0,0,102,1000,1134
818,0x1c68c81cf54b47fefb1e1dc0957d73f648ff6778,0,300,0,830,0,1130
819,0x135d022ead508d642e6adeca8ac709c32995ffa4,130,0,0,0,1000,1130
820,0x20a6d8d7dcc7109e747b8ca7cc98ff0c4cd5c78a,122,0,0,0,1000,1122
821,0x40f293766af55e2ced9d2bee7ef1d584bcee41d3,122,0,0,0,1000,1122
822,0x5f9780763ab15cb6a0d1820caa3c88b7256e06db,121,0,0,0,1000,1121
823,0xac4850b11ea4b349a28d23c6a956c28868919361,419,700,0,0,0,1119
824,0x47ec5bf15a7690fe91943e7a5af180b11072563a,119,0,0,0,1000,1119
825,0x91ca7ad6fafbba80cb48f13db481b72f158eb51a,118,0,0,0,1000,1118
826,0xb80b9b0cb84456cda37c37c3f956a870eeed19a5,117,0,0,0,1000,1117
827,0x3647d1ad6b8d505de32a8f23b624c6d0f306fa15,1115,0,0,0,0,1115
828,0x2d5b791946e6602df44c511610f984b0884ff6f5,115,0,0,0,1000,1115
829,0xc2d10994ebe2b19e5f02ae498cc5bba0d8324ea4,115,0,0,0,1000,1115
830,0x4e46f906dbaa7d0a482c4ac42fd37d2aa6aea4c1,1114,0,0,0,0,1114
831,0x684d9ff01229fcf673f53bf3fc89d471d15c680e,113,0,0,0,1000,1113
832,0x95a43c71b1f637d022c5697e290f6b1d56d70741,108,0,0,0,1000,1108
833,0x0a92fe79f50e14ccff955cb4d184cc067fbff67f,107,0,0,0,1000,1107
834,0x325d3a7b55a5a9f860689e827c15ebe202548d9c,106,0,0,0,1000,1106
835,0x5281ff3fa12221799782b7a40046f392c83f7bcd,105,0,0,0,1000,1105
836,0xab5a2094aaee082a9ba7f51507a1d00795a7c84c,103,0,0,0,1000,1103
837,0xefc6de6cb257fab33871c06b8f4f792ee913935c,2,800,0,300,0,1102
838,0x96ec9ebe7c780d34598c476e4b84efc9febd6af6,102,0,0,0,1000,1102
839,0x15ca18d689442e684ba2490b4df8a8ebdf4b010a,102,0,0,0,1000,1102
840,0xeccc5a950e9f6fb48ef481a1df8ad42ce37048d4,0,0,0,102,1000,1102
841,0x7f4740f30eda35c0e3c20ab5c3f569412ee23cdf,101,0,0,0,1000,1101
842,0x100105dc358a639c091c2e111f660e080e7382cb,101,0,0,0,1000,1101
843,0xc665a60f22dda926b920deb8ffac0ef9d8a17460,0,1100,0,0,0,1100
844,0xbcdacd0d392474bf26a13b76115cd8acfe1ed25d,100,0,0,0,1000,1100
845,0xce251ad55a4436dc0ada72276f41454350d4959c,100,0,0,0,1000,1100
846,0xb624bdd119162651d19402778c6ab6c8c14a3fd9,100,0,0,0,1000,1100
847,0xcafb1238568de759553b6d3db98b9f97a58e9859,99,0,0,0,1000,1099
848,0x0cd505699047473fa3f76accd04e9358a06893fd,99,0,0,0,1000,1099
849,0xf2e68e8c83264759c9b597b74809ccf59e3cb48b,98,0,0,0,1000,1098
850,0x27dd92370b9eb8a085d5f0cfc33e4af60abe747f,97,0,0,0,1000,1097
851,0x025a7c8c43090c4080ada7f0c61a97880da9b5e9,97,0,0,0,1000,1097
852,0x4961c3513792b724319d590a7a7c58bdf3276d0e,92,0,0,0,1000,1092
853,0x138e20085c49a240a4b54920913f5b5be3aefbb5,88,0,0,0,1000,1088
854,0x9f6c9cd474888a73ecc29ebde0da20e25661e9da,88,0,0,0,1000,1088
855,0x82797c484db1cd069c2a90decb8677da969cecdd,87,0,0,0,1000,1087
856,0xab1443b4c89bedfba5d39dda465dcf92a6f77a7c,85,0,0,0,1000,1085
857,0xc82cd5da19dbcb6f175950e3cbf62f2d41cf88b0,84,0,0,0,1000,1084
858,0x679791d0661dd64432aa5d532bd9b0bd40253a71,84,0,0,0,1000,1084
859,0xc4cb94fc1b7d5ba8972bc82e148fd85373487dfc,81,0,0,0,1000,1081
860,0xbad3bf0e52b5d3f91bdcacc5cfa94a97cb9aaad3,1079,0,0,0,0,1079
861,0x9df4e4a864f86e4cd069c505b9de13a52e724218,79,0,0,0,1000,1079
862,0xd867eaed614b09542d76bccdf86b7fc62b9cc3d2,78,0,0,0,1000,1078
863,0x630dd1c24078a74ecc9eaa1513647dd848985589,78,0,0,0,1000,1078
864,0x96dc044a371b4ecaaf8f0c7d05d71970469011ce,1027,50,0,0,0,1077
865,0x74cf986a8ccad6cb940a31b426243bbbef629ce2,26,50,0,0,1000,1076
866,0xc2881f531e6769024b30788c30e3de73cab7a2a4,75,0,0,0,1000,1075
867,0x9bcd123caaaca584b2bebfd534cd22c762b5bdf3,71,0,0,0,1000,1071
868,0xa37814bcd4dc9b13c9572b17837c6fa55143b625,70,0,0,0,1000,1070
869,0x5d62dd87f40090ba3d065b4c6bb63b8c8ff883b3,68,0,0,0,1000,1068
870,0xea76b3b66ddfd16be5e2b86f994408a65e72862a,66,0,0,0,1000,1066
871,0xb2d4fdbd97ebf067cd19f23366ef87e2aeef1a70,66,0,0,0,1000,1066
872,0x8ecdfc58423e37e0e32518589f2205b89ee9d950,64,0,0,0,1000,1064
873,0x4acc5a810b1efe2ac5de50f4e3e5a3a40b7b1cec,640,0,0,422,0,1062
874,0x2097cb2c883ece6b966974f2f8a6ce42aa209892,62,0,0,0,1000,1062
875,0x9a6c06a7c2adc5b9e9d5de6499be1eac134e6fec,62,0,0,0,1000,1062
876,0xb1548ad97a67ed757ec311e023ef64a659969429,99,0,0,962,0,1061
877,0x4a65341ede610a7b796c96887c04a0462ddc65ae,60,0,0,0,1000,1060
878,0xa994afc601152567adebd4ffbc361874109eb40e,57,0,0,0,1000,1057
879,0x5ad07cd432804b037710f5282946fda4e5bb27b0,151,350,0,550,0,1051
880,0xa1413fcc75885e55962e31403d14f1414ade43f9,51,0,0,0,1000,1051
881,0xa193e214deaaffdcd79c6c7c2bd33917ff15e58c,51,0,0,0,1000,1051
882,0xafe025cf1ff26fce725e9fe7f627a411925c024c,50,0,0,0,1000,1050
883,0x39012a6ec8a026856c4e8863f0a6297478409a9d,0,50,0,0,1000,1050
884,0xffd971d72f77fefcee7f450eb90a828296e6fd6f,0,50,0,0,1000,1050
885,0xc5e38233cc0d7cff9340e6139367aba498ec9b18,0,50,0,0,1000,1050
886,0xde2d1c15ccb4c753aff518162b3ce647858d5ca5,48,0,0,0,1000,1048
887,0x9e3a504bc14dfcdb4d6a837db021209367c2af4e,45,0,0,0,1000,1045
888,0x222cd3cbb775b6ac76e7234672e146a033b07081,44,0,0,0,1000,1044
889,0x1655e400492c71de855178301aa4f8095c4753d2,41,0,0,0,1000,1041
890,0x92cb71850aa43263ebaaa1e0ed3e78cb984915ff,41,0,0,0,1000,1041
891,0x9d85fd06a8b79417d1f6edd9336925e7569adac1,40,0,0,0,1000,1040
892,0x8d4ef6dee81d91261571eae09288c122ec37ca64,40,0,0,0,1000,1040
893,0xe88c9d2e3ffa77b649c42de1070d9f0d463aa8ac,38,0,0,0,1000,1038
894,0xad615f88d4483b80dd415a0cf533c027d6ecde01,38,0,0,0,1000,1038
895,0xafa633e8df348958fef554170b322ed4d660a091,38,0,0,0,1000,1038
896,0x294af89e9c338f5f0b54bdfa7db81af97f6cd24b,36,0,0,0,1000,1036
897,0xf8f09322111e2d5fd6a83c1f730a277e19bfb29c,35,0,0,0,1000,1035
898,0x77cf1c1415901552af807f19106ff2a425c2c92f,35,0,0,0,1000,1035
899,0x79639ede3e164fb3549608f48ccce9712d604abb,33,0,0,0,1000,1033
900,0x9db1522c999360f070a09de39ce3fc801a8429e3,29,0,0,0,1000,1029
901,0x4a95820c8fb15b3de2aabd512a368a45e22140a1,29,0,0,0,1000,1029
902,0x25b335f53e3e09d854a125c36fb9bc722c743ff0,29,0,0,0,1000,1029
903,0xa0c59fe11305a4f62692a41198099c01dc271be3,28,0,0,0,1000,1028
904,0x220cf5ece2fced6ab7f66a68e6fa7418e3ee77ed,27,0,0,0,1000,1027
905,0xfb628282516a371d4da2510baa792dc4cae8c6f0,27,0,0,0,1000,1027
906,0x461ec7e9277a31207f9169b8309ea242e256dd89,26,0,0,0,1000,1026
907,0xfc8564a368a54728a24bae4b9c253cdf3d7a7e74,26,0,0,0,1000,1026
908,0x29b15d34f300fddb5fa050f525a78555137c17cf,26,0,0,0,1000,1026
909,0x46179d5fc91198a234cd07556d7ed40cede173d3,871,0,0,154,0,1025
910,0xb35e598fc643037facde62dba4343e99f6294958,790,0,0,232,0,1022
911,0xf649efff7c470fa5f9a0381011b52ddc958479e7,22,0,0,0,1000,1022
912,0xff8676e8fd7bd34a13627b60746e653a3c10e9fa,1021,0,0,0,0,1021
913,0x5db4faaa0caac428da03a210b0fa4984e963d009,20,0,0,0,1000,1020
914,0xe82c20f6911ef8a0af094b2996a1c38f13d8a3a8,423,200,0,393,0,1016
915,0x08bd72927d0c74dacf652f907f2e9182f5585644,15,0,0,0,1000,1015
916,0x140558dd7c4b58b7fa9978cf268ad2f02484d8ec,12,0,0,0,1000,1012
917,0xf1d5221c31bfe10baeeeae021e2bff3d14a7a966,12,0,0,0,1000,1012
918,0x2e279050df301fe4f3a557f027cdd85ca34b99db,11,0,0,0,1000,1011
919,0xbbc1a739e946afb7bcf24a95a3656948e615fb05,11,0,0,0,1000,1011
920,0x7792546a9030756a858bf16c29f8e62abe9d37d4,8,0,0,0,1000,1008
921,0x1698b923e300842536ea0bfcc6df593b354fad54,7,0,0,0,1000,1007
922,0x1c5b8f3389b796c5aa711e9b14ed2c6b94c6530a,6,0,0,0,1000,1006
923,0x5935d00f683b420a5cf00890a64c658f06204bc4,5,0,0,0,1000,1005
924,0x4c0aca1031913e3c0ca7a1147f39a8588e04c55d,4,0,0,0,1000,1004
925,0xab0a7096c9a0a2dd29b1b460a21f6437a73f0de9,0,1000,0,0,0,1000
926,0x379b6057408798e33600545fedc6dcc654d9d608,997,0,0,0,0,997
927,0x6e2c8cdf5358ae773255ae279208f9612cb810c3,830,0,0,135,0,965
928,0xadd09393e55a941355981b3934b82daeb5256de0,412,550,0,0,0,962
929,0xf85a26cce4aa90ab2338079de5342fb8f3bc2e80,500,150,0,300,0,950
930,0x5680846aa7d3175341698dce493d71add55969a5,946,0,0,0,0,946
931,0x852e8017522b4099aad8f067328301a40298be8b,923,0,0,0,0,923
932,0x7a6538b45842807650c9bcbe67aed560ba89f0d2,852,0,0,0,0,852
933,0x3cf58b8c135f5457b0541637356fa183b5a4aa98,836,0,0,0,0,836
934,0x9538fd48f3c658cbd625c6fcb462926ced08e7a5,824,0,0,0,0,824
935,0x68e254134e37df7b2f078994cfccb305996c8bd1,810,0,0,0,0,810
936,0x55b122434cd5a05add75542ef3103299699280d0,0,800,0,0,0,800
937,0x792a317b2d3399a3b93c628a4d031f34df5e64e3,793,0,0,0,0,793
938,0x76b9c0c305d9b878d1b18099a9506b83aa3dcf73,590,0,0,200,0,790
939,0xc2521db7fc8160ad24eeb34b2468ae86b318e9e1,289,0,0,494,0,783
940,0x08a6d384f31f0da6ddd6e803278a278751ca3033,148,350,0,271,0,769
941,0xcf750321f84b967c71d4a428029bd05c6a281e79,622,0,0,140,0,762
942,0xf7b133a8c1bb9ce05c64d27eea4fb1fae4189ebb,757,0,0,0,0,757
943,0x93c075fa791f7eb593c2c005b63a79167f2f73e3,0,750,0,0,0,750
944,0x5f63007380c824452becd699ca25ff2dfde9e46d,743,0,0,0,0,743
945,0x980072215e8c0ee6871c352a20056467f295306d,183,550,0,0,0,733
946,0x8883fab434323caa54307ad69d66966d56d4fd7b,74,0,0,640,0,714
947,0x4eff5437fadc252cbeb982be65a97423a80b93d1,712,0,0,0,0,712
948,0x446278f03e7a640ecd13dd7ce05cfc9a3c31bf5c,605,100,0,0,0,705
949,0x46ca28bd0d01573ca98888ecd3ce78b8a4524d1e,204,500,0,0,0,704
950,0x2c667611c16570e73699500acfbd9e747687880d,334,250,0,120,0,704
951,0x64977f3597af83942b58d0bf997602fddaf8a969,699,0,0,0,0,699
952,0xeabc1a03686d37329e2773e04fd8901b860b9f41,698,0,0,0,0,698
953,0x0a6fb55d357e60b1c97c6385f926a469e62f16ac,685,0,0,0,0,685
954,0x5da361cc7dc43a4b96cd79a89cfb41d762badefa,0,250,0,434,0,684
955,0x7ca27459dae5944deade4aadbcb926f23818d0b0,682,0,0,0,0,682
956,0xac5e99b194689f6f4739986a345186484f81349e,269,0,0,413,0,682
957,0x225cbec3f58e6fb6eb09d9c4ec20f41cd75342e6,50,300,0,332,0,682
958,0xe0b9642e4941019827d3a117e17c1682133fadba,679,0,0,0,0,679
959,0x9cdd2eeab50d5c723ec76df6e8745a67f9fe08f2,311,0,0,367,0,678
960,0xe3cf905acec8bd71dbbc35b20e48e3fb55b0b97e,23,0,654,0,0,677
961,0xc4a849f36ebfa60fe177b251a0ea6a491493dd8a,178,0,0,491,0,669
962,0x39d57dc252da28a3f8ae94524e34ba1bfaaafc11,664,0,0,0,0,664
963,0xdabf8271fd74b1690f61685ede180ef7a4d6a746,412,250,0,0,0,662
964,0x0db745c3a9eba93ada5d223ac137d37f8a11413f,5,0,656,0,0,661
965,0x8ed0dba9bd9a45f026451dd44ccdf13daaa86de1,654,0,0,0,0,654
966,0xcb57a32a7febb93d982ffb32415e41fc42901031,0,650,0,0,0,650
967,0xa09b89d1eafc9e49d6100c4a6d3e957ed2a881d3,448,200,0,0,0,648
968,0xf51f4cc009f1cc08bf9e1e381a10c1869edbbf94,507,0,0,137,0,644
969,0xe6fc39b950a148d651172c9fe855e91af1aba021,337,200,0,106,0,643
970,0x0da5bb8c563ceb988cfe6f3b8281fab533df510c,642,0,0,0,0,642
971,0xd0989a367a1e9cf1549c870cb245e86acdc81ad9,641,0,0,0,0,641
972,0xa689450eb2eca0b870b984ba34806d977420c8b7,527,0,0,108,0,635
973,0x87034c3e49a8b797423c9d21be4051889cc59b0d,432,0,0,200,0,632
974,0xdaa98a08ee8f997ad1ea0daa093198a25cea90cb,276,350,0,0,0,626
975,0xa802632240b0aec7d413c0b94f93932ae099e638,622,0,0,0,0,622
976,0x3b2b39dd790765f2468a05152d4ca4582776c8d3,559,50,0,0,0,609
977,0x77b14f509c1de672aa6d3260c9f6244e7252f332,0,600,0,0,0,600
978,0x8655fa254cb9f79a16f6067b664adc5ff3c49728,595,0,0,0,0,595
979,0x5c3ee48b824299099f00fa346976616d1cbe8079,493,0,0,101,0,594
980,0xd5c544e7fd5e2b6b87feb962cc1e61a6f85db070,587,0,0,0,0,587
981,0x72565a43c1c9f8b070ab3d091ff33627e3000ff8,249,150,0,186,0,585
982,0xc3375e04e6904611e4fc8ae91aa2b8d35b1629a6,534,50,0,0,0,584
983,0xa0d751cae2ba4d1c5f2566767fd70e6130729667,433,150,0,0,0,583
984,0x5564fa1d6f81af96211c363cef314a33463c921f,281,300,0,0,0,581
985,0x84e799bc5e470e97f04dd3873c0089b826b2d1d0,578,0,0,0,0,578
986,0xfa099f4bb7de013c99f4ccac78a797069159cc20,320,250,0,0,0,570
987,0xc49a8174ad53b9631b7d9e18ccf31168615245bc,267,0,0,300,0,567
988,0x56b1c3aceb40cdbb9c969bd8290b21c7dab81332,359,0,0,200,0,559
989,0xf4e8497a821f73c3b2a3720bf54c8c34fa938de5,0,550,0,0,0,550
990,0x56109ba6f73e16032abdae012cf31f4d87067057,0,550,0,0,0,550
991,0xd68032e9c0d6e3e8d6138b228202fdfa1cc44bb0,549,0,0,0,0,549
992,0x8e0962872555147d88ee733bdb1bccf522f6dd3d,95,450,0,0,0,545
993,0xb6164af04291d3aa4051ee78943618318e3f5cef,542,0,0,0,0,542
994,0xe2efef4c6ef4d94b462c75a203af8570f7e1e518,537,0,0,0,0,537
995,0x53f39db15a6ac87c44fd77835760b59a746627d7,529,0,0,0,0,529
996,0xcdec3c9f96917c6782362018a46841d35559d09c,328,200,0,0,0,528
997,0x41029f49b6fe8338695351a0fdf687f896700b0b,125,400,0,0,0,525
998,0xbced0a284972554c3bdd30e6597cc9c47af2cbb3,157,0,0,367,0,524
999,0xe93a1d96db1ea72eab4a89896d42b98a15f3e31d,0,0,0,521,0,521
1000,0xa1048201bef254132b4aa9484a7c30a5c1f69843,519,0,0,0,0,519
1001,0x2d2aea873408bd23c800f7463d0899b55283af96,108,250,0,160,0,518
1002,0x891eb42893e2a261305f61e9a8bf3590b28c78d9,515,0,0,0,0,515
1003,0x9de7096f175dfa7d20f2feba1996a0e965f381e8,3,500,0,0,0,503
1004,0x240580dbd8c0769f03347505b366966fff2da6e4,252,250,0,0,0,502
1005,0xb746178346c860f806dca44b47110022683ac1bc,0,500,0,0,0,500
1006,0x570a5c3b880de0c14c755ac6c929fe98a170e908,499,0,0,0,0,499
1007,0x641e9415e7fdd55a020fe35b5fa3aaeb852dd8ef,199,0,0,300,0,499
1008,0x4300a9c7045ff514e54334614a0feb346905670e,497,0,0,0,0,497
1009,0x24d97b4a874de0be1f9020d58c4fd143b5cb47ec,496,0,0,0,0,496
1010,0xc1692cd69493436b01cddcbe5fedbc911746a7c1,45,450,0,0,0,495
1011,0xb490dde9273c5042b1c4e18aa1d551853b4862d0,190,300,0,0,0,490
1012,0x4d2cde8d65be8be6cb7eca5c07917f26957aaa8d,147,0,0,343,0,490
1013,0xc4c2985fb2b78893e32d2f2b170edccbbf3d46a9,488,0,0,0,0,488
1014,0x47484fb1c78497f8f60b43d68c0c8a88689cdef9,487,0,0,0,0,487
1015,0xc87d5e923deacd2b8a122050b60532a927c2c7cc,485,0,0,0,0,485
1016,0x6a060bd48ddad506c7fce62a99fd1e8054697344,481,0,0,0,0,481
1017,0x1af7f98074c49b6389fbede61568f7b92ad03368,480,0,0,0,0,480
1018,0x0e5c1895be0c07a1b08fb97b98fb7a44bfa4ade4,0,300,0,180,0,480
1019,0xb640936672d4477caf1d29b5af03698d04179c5c,276,200,0,0,0,476
1020,0xf6855cbbe6a2d3f924c62578e36599e36ea1af4d,474,0,0,0,0,474
1021,0xee35ecd92ecee35cfbe2b3b42bd5052279f7eeb9,298,0,0,165,0,463
1022,0x3c7d1286d61e3265c3fc114618a0d0edff30fb94,184,0,0,276,0,460
1023,0xb3537919f8b4bca79ac0e7df8b5f254f4f88bc37,270,0,0,187,0,457
1024,0x330a21a4f5f68f56afedc64edae40f04b139bb34,456,0,0,0,0,456
1025,0x53e1a22a0361497b796d52a8fdb2d66508deac5f,204,150,0,100,0,454
1026,0xe26ac5e6657da43a049335174043d3576bf5db88,0,450,0,0,0,450
1027,0x35b656b5ec5c9026dffe3c4c60ff25944f09e732,0,450,0,0,0,450
1028,0x277f5499b1db94e215f24db590334cd488df7d44,450,0,0,0,0,450
1029,0xce233e6982e622cd76160634dfde036a33e5df3b,0,450,0,0,0,450
1030,0x44a3a18df15ae79bbc6c660db59428fe9a181864,0,450,0,0,0,450
1031,0xd2127a26a6c53d523a28a61c081e9298087f517d,285,0,0,164,0,449
1032,0xabcb8a6453632b099a8273d12debbae27608b972,449,0,0,0,0,449
1033,0xc613f927d0ef928411a3ed053f7a66746dcd56eb,449,0,0,0,0,449
1034,0xcd2c3e0d5d92e63b605bf757397f9bc21736ae9f,338,0,0,111,0,449
1035,0x7fa41cac061f3545a1b355539ccb810ffe67e765,443,0,0,0,0,443
1036,0x47410481b5196fed97b27155dbace4a83129eeb7,440,0,0,0,0,440
1037,0x4d0cacd39d92f7e50a75e68db253b4247739df46,34,400,0,0,0,434
1038,0x95d6af5c05a0fe59e2dd69ea83d63224c37d01ad,433,0,0,0,0,433
1039,0x245119a0e70c003da9060327ff203fc96b98fea9,430,0,0,0,0,430
1040,0x4390b9fdb1099805e36f9d1a6b33b290719cd0c0,79,200,0,150,0,429
1041,0x91d7b8c6296b57964a6fa18fd1eae4e75a4504b6,428,0,0,0,0,428
1042,0xcdf69387fdac0e97fad54e96b4278a5d8ffac9d8,428,0,0,0,0,428
1043,0xa4adc8abe09cf3c06f353576c2e9886eef815ebe,424,0,0,0,0,424
1044,0xb43d4ba97a3afd470b16203f81a1cd05964032e1,173,100,0,150,0,423
1045,0x0a70c5f67d5102b5211d30179c2436dde200c073,423,0,0,0,0,423
1046,0x34a67360a4c6a691a36a9f2ae6444d8baac967ca,22,0,400,0,0,422
1047,0xb75f746f4d626b50228f445f94d18f7988eae4de,413,0,0,0,0,413
1048,0x7c947f44a59338539f3a118acd45d43c736afb42,15,0,0,397,0,412
1049,0x37e0813fc060c32d03911080055f4560eeda7570,226,0,0,185,0,411
1050,0xadeb918f37efd8e19926ec8e78b4a91df6b93fb9,411,0,0,0,0,411
1051,0x4dc0e2040bca9faccf5333e2cc765301f11f2a7b,410,0,0,0,0,410
1052,0x08b5bfeb412443cfc54e38656ae88f6bdde4920f,255,150,0,0,0,405
1053,0xd89f4745758e6ba09e9fdbf58d4f9824ad1ca097,403,0,0,0,0,403
1054,0x3cef49954ba6cc3b9e400f0916f83ea29ac10483,403,0,0,0,0,403
1055,0x2b821c78bbde12e2bd46433b4974b26dfbe8727a,0,400,0,0,0,400
1056,0x515d1a7b1982826d53194e03fbbacdf392034b83,0,400,0,0,0,400
1057,0x2f6c47459a02cde6c331505db2194db6af68c332,0,400,0,0,0,400
1058,0x1017705a2eb058d40a70c5618714eb07574a0b3b,0,400,0,0,0,400
1059,0xaf85cf62ea52e5875229f571b148a9041355aff6,0,400,0,0,0,400
1060,0x9672cff9f81a9e4953ae5ba9792e309fd8858634,398,0,0,0,0,398
1061,0x976a8e1b668960f95b863871f40f7f9cfbbc109a,396,0,0,0,0,396
1062,0x447ba3dc3a8fb4b810d81c640337d715e06a9dd9,194,0,0,200,0,394
1063,0xf72aed41b23372fdd81c1977b2ace051ab5a861b,393,0,0,0,0,393
1064,0x8ba45ad7f325c8db0a33b9490b97bf2583cc61f7,392,0,0,0,0,392
1065,0x42c02dca2318a495fcf992c70549a4dbf1f9f36d,391,0,0,0,0,391
1066,0x1a40da0461aa7c297abdc198e4a41bde9feb0b95,91,300,0,0,0,391
1067,0x7d042740597c3587d1fd2dd1228fb747760085bb,391,0,0,0,0,391
1068,0x807878c3c92cdfdda6638227f55566ed9b80c40d,390,0,0,0,0,390
1069,0xbacc0593392a08f4293d7c61f5402a5bae8b7ab9,387,0,0,0,0,387
1070,0xf65c0fe7c41cc0156ea7c3aee78017f7e4e9eda8,384,0,0,0,0,384
1071,0xe8432aa8c31ba02b14c4ba50d57a0410bab480c4,133,150,0,100,0,383
1072,0x831b6c6bde238e79432770b24ccc81a666aac00f,96,0,0,285,0,381
1073,0x2c401daba885efbf35e1a7202cff2320cd8d7e81,377,0,0,0,0,377
1074,0x7265b0ce7a802957818e85f5d6f6d5be118256d9,26,0,350,0,0,376
1075,0x32ed43351b53443cf4dc56882e181e70f6b2b3e9,76,0,0,300,0,376
1076,0xd73f2e1aafd4e8dde032b55fb55aa72746a8c453,76,300,0,0,0,376
1077,0x2d73acfd54ce9ba86880309c56709c5ff0d455dd,158,0,0,216,0,374
1078,0xa8213ce9609df068e1e3b764c6d0d0be4fca5af0,374,0,0,0,0,374
1079,0xe6b7081442a844a931be07f5eeb982422c463dbc,372,0,0,0,0,372
1080,0x2dec9d45fee0ae0e7ea94f4a2046eb2c83d1003e,184,0,0,188,0,372
1081,0x44ed19269d4f87a2965234254a30b660a5f743f4,370,0,0,0,0,370
1082,0xbc49d1d841e9b076cc5b32ca74308e3e8fdd88b8,368,0,0,0,0,368
1083,0x79a2e9c8eceeb6abed99426793f829c16289d310,367,0,0,0,0,367
1084,0x481107e637a8ed3c8b3037583623e9ce3b44fd60,365,0,0,0,0,365
1085,0xed0656bbb366c28ea1ad274b931278df34bd1865,363,0,0,0,0,363
1086,0x6ac0b175b161e9446bf49577a19988846634ba3e,359,0,0,0,0,359
1087,0x91129dd65ee823fe09bccf178128cb80275eb95e,208,150,0,0,0,358
1088,0x9043110c91830bf1bf2348b3f41361ba3c2d257c,358,0,0,0,0,358
1089,0xbeaa78e5d0b8b828d6fb5881d7676da8afe70785,208,150,0,0,0,358
1090,0xeca952bf7d4eaaeea84265dc620a10df4500352b,357,0,0,0,0,357
1091,0x59cf02879e5a44cbc636aa355b796eff91627441,57,300,0,0,0,357
1092,0x243946adf1be7c01e4803ab4000b298401d1c786,356,0,0,0,0,356
1093,0xe4433eb39c8a76c44d7551f3ac83b282292a5d9b,356,0,0,0,0,356
1094,0x43334b02903f3786cefb00b03958890066f56ea2,351,0,0,0,0,351
1095,0xd19b5ea473333582df7104af19ca621fadebf6ea,350,0,0,0,0,350
1096,0xf653cfa85eacd26ad8b9ecabbfadee52e8d9fa72,0,350,0,0,0,350
1097,0x7e5161ebbb67e6d47d23f0c88bc2552d1f76b478,0,350,0,0,0,350
1098,0xd4254433f6e1384da6a570c076904b4ddc96107e,0,200,0,150,0,350
1099,0x9a5de406267fd5d7bee4d52283cf1429e2c1fbe9,350,0,0,0,0,350
1100,0x6a952452c6b71d60fa47cb8e5adeffa204473df7,349,0,0,0,0,349
1101,0xccf156eea8c32939e313c3fb40d349c86e1b0331,345,0,0,0,0,345
1102,0x8b1dd48344de9922ac1f24b7563fc07ebaa00b20,342,0,0,0,0,342
1103,0x3b940c6fb7aaa4c1bd34c63e0e4a6ae418e8f38e,342,0,0,0,0,342
1104,0xc379e5ed094040015781c5bc2e182211549d8087,99,0,0,242,0,341
1105,0x7bc5ef7c8118b5722b2024fe724d0d035f73f7b9,340,0,0,0,0,340
1106,0xebbef5e1d4c7a13a70567830731bf2f44576c785,339,0,0,0,0,339
1107,0xa9ce55c042b3ba7a515ad1cd71078e09eba82296,339,0,0,0,0,339
1108,0xedfef05fe9377e6ea872ca77ea8ea3a954a54e07,338,0,0,0,0,338
1109,0x34204ce7135cb424f7dbd3f96ef7fc14df29b503,338,0,0,0,0,338
1110,0x1e1e7971e6a6a766628c3be3d255512d84b25961,333,0,0,0,0,333
1111,0xf21d6d86dc7468cabcbaba38d37a1a9bb9387913,21,0,310,0,0,331
1112,0x75037b9da3e6be046e78eff423f03ea7c58d1973,330,0,0,0,0,330
1113,0x250d6d3cf402863ecbdaed01eeb3e5b75a1a9f88,80,250,0,0,0,330
1114,0x8b97816190919c94d88ae3344e96fbed12c7aa8a,329,0,0,0,0,329
1115,0xc2151b3ce196c41a3d204ad87523d9391e3a0f13,278,50,0,0,0,328
1116,0xdd61ba077e256681a64e8e67101848599694346a,328,0,0,0,0,328
1117,0x992080106883cab3b9b15081c24ca7174c50aa06,75,0,0,250,0,325
1118,0x6f95b2e20ca71093650eb4ef00d22fc2816b93de,324,0,0,0,0,324
1119,0xba73bcd00c5f1a8c48b2a415399e7373d191c506,221,0,0,103,0,324
1120,0xa31b837bb778cc7211bb0424a6e7a02f3b86d994,324,0,0,0,0,324
1121,0x880a6505c907ce1a4d3df5cb32a90903337ed3d6,324,0,0,0,0,324
1122,0x1d08a3d8f78fcc77bc1c428d4779c3e14abaab3b,122,0,0,200,0,322
1123,0x1b0b8b70657e41bd136e1ef5ed61a25c5abb5316,321,0,0,0,0,321
1124,0xeb23ae106a0a81d5f6be456c4cf7a0d460d29be7,320,0,0,0,0,320
1125,0x3591e4e93b14ed8185bdfc83f63d67038d75e4e0,267,50,0,0,0,317
1126,0x786b9dc8e864f275a983e6dfb6ee85094df794d4,316,0,0,0,0,316
1127,0x33c69a474b2b5ecfe61b53d7daf3d98eab075987,180,0,0,136,0,316
1128,0xe37edcd3726b205d176edf03f65ef9ca62121c7b,71,50,0,195,0,316
1129,0x31ec607e3c62547910c77bb45a7d655a84f859ff,165,150,0,0,0,315
1130,0xb8d2f0e09b1d37b6ab1eef1ac25d05dfbff4fd6b,188,0,0,127,0,315
1131,0x274511c27f659187d5c01cae69af0361e9f388c3,214,0,0,100,0,314
1132,0x473eab8d834c4fa9d5fc5a55560cdb1289cfe923,114,200,0,0,0,314
1133,0x67c4e74eaa79b6f7114b56d17b5bed2f60c69fb5,162,150,0,0,0,312
1134,0xdb1f6231351f2d25dd41637fbc8d7a1da1601a0b,11,300,0,0,0,311
1135,0xb3684400b5a8e5c96db1925e849a923640b9f8a5,11,0,300,0,0,311
1136,0xe9ea7853066926294470677a35c8d068df621f6d,160,0,0,150,0,310
1137,0xdc1a1092e1e082ad35946da06d30345d4835f902,257,50,0,0,0,307
1138,0x0fdf474dcd6cc04702b35d48fc459b61973c9421,157,150,0,0,0,307
1139,0xdfd804f4fa2e5452cdd3e1f4a9fd84aa731fa7b3,306,0,0,0,0,306
1140,0xd1641fc6c87dc220234996723e8e566b037b8fb1,36,0,0,270,0,306
1141,0xf928edae51f0110c390346f1c50c5586bfe24746,3,50,0,250,0,303
1142,0xeac1ae4cc1f2f56167584a5351c766e656043243,0,300,0,0,0,300
1143,0xc93bffbfb002929595de620cdbe4328c8e4c56d5,0,300,0,0,0,300
1144,0x25ce7e3835c63360a573bdc088c91e28dfbdb32c,0,300,0,0,0,300
1145,0xbe5ed0c6bdf805ca57adb8a81a4c8fc5e5d297cc,0,300,0,0,0,300
1146,0x142a959b999d6227581ede114a0a6aff608f4ec2,0,300,0,0,0,300
1147,0xa953eedfe93b1a0120ac65523a1ee783c7f9b75b,0,300,0,0,0,300
1148,0x7ab96ab53b725e670ee061bea6507d49399a9766,0,300,0,0,0,300
1149,0xe039f80a6aa42f256016d64e3cbf07a4b6e9d5dd,298,0,0,0,0,298
1150,0xbcf59dc3140ff2b2737f0c441cc8da865b2623af,98,0,0,200,0,298
1151,0xeab7715b8f5c84297d882c3d56199b45e0781630,298,0,0,0,0,298
1152,0xc6214a018379f699aa206c94d42d7dfd161fc537,298,0,0,0,0,298
1153,0x6d841518714e9f0fd60dde9fa3169fd7711b2122,47,250,0,0,0,297
1154,0x62ceeb44d403358cf1916a1a980fe898a281e464,297,0,0,0,0,297
1155,0x8a1cd21203bb4c953ab52076f71f4f9a1bad771e,295,0,0,0,0,295
1156,0x76395c496555b344da8554ed99fa369741a85015,293,0,0,0,0,293
1157,0xf4770a3e263c9055d5a4bce14b54aed8e87e67ea,99,50,0,144,0,293
1158,0x3aea2c0b21437242d33c16683cd6b1cafa5360dd,97,0,0,193,0,290
1159,0x2d3e0354dac8741dbf2346fa76b557e5cd483ea9,289,0,0,0,0,289
1160,0x93da9372b4c2bc412ef3cf69e80f461ffa52d151,289,0,0,0,0,289
1161,0xe725637786dd65d0ba0a7f9e0ebc468bff71a957,288,0,0,0,0,288
1162,0x672b8cb451a0fb81f3e0d146bac2e2a5dff21039,128,0,0,160,0,288
1163,0x463b8483fb4471e0c67be9aa7085c13f470ba374,287,0,0,0,0,287
1164,0x1346c787ee8b9a25094194070d39ac7da2f3b25b,286,0,0,0,0,286
1165,0x457e57e36048f1189d1f83b6f94371cbc504a476,121,0,165,0,0,286
1166,0x4b935cea8b69733da353b92489bbdbad0d0a8620,286,0,0,0,0,286
1167,0xf6dab22d6fabc48998ee783c38afd1ac700fbefe,285,0,0,0,0,285
1168,0x1b56eb67f280add7cfe89727aca1134274443a39,284,0,0,0,0,284
1169,0x920be929adf29b9be8eff0fd2d6d2eba2dceac17,284,0,0,0,0,284
1170,0xb8ca94671bc81977afc8a850c4e753137f1d8e47,184,0,0,100,0,284
1171,0xc347d21724f94b634eee68994b9a3dce91c7a611,157,0,0,125,0,282
1172,0xa832bf5d6b53c24e4e2199f97f80e7875c55981d,29,0,250,0,0,279
1173,0x7948a392c7c96c419a3a4b950a0e757d59cddc00,114,0,0,165,0,279
1174,0x3efd9d04c4c86e9aa97672ec43e0b90fe2e9c5af,127,150,0,0,0,277
1175,0x74f074dae44c6beb3eae6cd4cce88fb09bf03559,225,50,0,0,0,275
1176,0x3f88cf4b6a2aad04514ee3b82f002d1ea71b4c5a,74,0,0,200,0,274
1177,0x8cc1440425a7e771162aebd8a88a585aba43bf25,73,0,0,200,0,273
1178,0x3b5e8c9a5ca07c943e9c7dc56ce003ebfda32af3,54,0,0,219,0,273
1179,0x52526a26f5c852e62c82876fe783ecb9b37d1a49,23,250,0,0,0,273
1180,0x52f9765636d7f0d8b10c4af0430ef4547b6bb609,271,0,0,0,0,271
1181,0x8467b1323b0a0af2495e69187abafcf0b628a8b1,270,0,0,0,0,270
1182,0x22fd24ba480333b13897b19f42b073166bda9933,269,0,0,0,0,269
1183,0x0c5cbc859435d0150e20964a1ab64903a3695c9c,18,0,0,250,0,268
1184,0xfb03105264d1d0fd6ed6aa85a668b7a7fdd941b5,267,0,0,0,0,267
1185,0x86fd0b493ba15de3ec3bcbf9bcf9322c84338ed0,267,0,0,0,0,267
1186,0x0f78f3014499d1541eaaadb82321709ec538d293,267,0,0,0,0,267
1187,0x6d15c238676bbbfd913822713d971cdfc170e2df,266,0,0,0,0,266
1188,0xda0592789a95f2d80c23756bc31551c7f0c1e6a2,23,0,0,242,0,265
1189,0x7b4130e1b552f6364d531f50e073535f47e93360,165,0,0,100,0,265
1190,0x1f49fb7f9565791aad182bd92ab402abec13d668,102,0,0,160,0,262
1191,0xbbdfa301038bc2f01ee63842e4872b3758b4c311,160,0,0,101,0,261
1192,0xe39048cd55c79b7276b66e0d407dea4f2b745af8,260,0,0,0,0,260
1193,0x10354bfd40d9a17800db496b70503b21f7d047d2,260,0,0,0,0,260
1194,0x7910453d06a303b76360a3a80ee914fcdf3c560d,258,0,0,0,0,258
1195,0x9d68e3379fe565aa858b67baefba0158622c9fb9,86,0,0,171,0,257
1196,0x46ea31cbf8536bf3658a4eb42315558b3f8f8ebc,96,0,0,160,0,256
1197,0x1c5f6ca2732ed0c9dbaec808ded3a34ffdc40ebb,256,0,0,0,0,256
1198,0x8fa42ff0b6a6b696c6f419ff827d07002d76b456,154,100,0,0,0,254
1199,0x4dfafd2d7bfcba6a9dd6e5c6adf44b87c053a485,138,0,0,116,0,254
1200,0xea44c07b51b8ec1b88fc9357b2b979a8fbe4435d,86,0,0,167,0,253
1201,0xc3452e4f0097e98cad7392db2cafd2f0de24b4e1,253,0,0,0,0,253
1202,0xfc638f22192f90cb236335b14f085d4a9191e55f,253,0,0,0,0,253
1203,0x2b40cdf716c8472bd9e3b10d73d8b4926c180fb7,252,0,0,0,0,252
1204,0xe45054686da706899dc5a5816cff12664b8a0703,101,150,0,0,0,251
1205,0x36862854accf124d08598b707e7008b54631a68a,0,250,0,0,0,250
1206,0x1df805e20038d0cc15a323206188fae70435a8b7,0,250,0,0,0,250
1207,0x4ab06e403ba9e1fa33fab92dbb5b7312e37e25cf,0,250,0,0,0,250
1208,0xba78cd28f7132958235d278ff3c5dc5e6d34cc15,0,250,0,0,0,250
1209,0x3d67157c8dd8d23b7d5bb57589660718db3fd8c9,0,250,0,0,0,250
1210,0x9399979f3802cd1249c562b8b52e41a801228388,250,0,0,0,0,250
1211,0xb6988cc40d43b4e8a90b8425d2de75b5ec100802,0,250,0,0,0,250
1212,0xd5366f70d7cddb57593c22993ec30fb130875473,249,0,0,0,0,249
1213,0xa595d9f72be04180738d1e5663bd727ee041b8f4,247,0,0,0,0,247
1214,0xf458b782ef1a18b9290e61465c9f099885fb849e,142,0,0,104,0,246
1215,0xe78b4eff96dd4ca9e49995335532410f69394cfb,245,0,0,0,0,245
1216,0x116a79b903acf55498b6c73be8a45d0ae7d1f42a,245,0,0,0,0,245
1217,0xcd02cff5ae858d0c79de4475458f5cb0ad01722f,69,0,0,175,0,244
1218,0x350ab5050c1aec58a6013a6ebc8b15a072dde121,39,0,0,204,0,243
1219,0x4f7e161ae2086f1bfc41099cb1ba252d8fc82650,42,200,0,0,0,242
1220,0xefd4aa8f954ebdea82b8757c029fc8475a45e9cd,242,0,0,0,0,242
1221,0x457a7e02e3f3621e003f9075feeade1be07412ce,239,0,0,0,0,239
1222,0xd5f2aeb6cf75f86f5c2bc5dcfc9e7673f67666fc,139,100,0,0,0,239
1223,0xa2681f6398f33cb7a9bd7a87c7df92f77c104fed,238,0,0,0,0,238
1224,0x8101c452ed4ae5c0af5385eb5dfca47ee0effd32,236,0,0,0,0,236
1225,0x26363c0f3ffc157a39bad6b18cdb0af97e1f287a,235,0,0,0,0,235
1226,0xfa34333cc64b7375c9df9577b715379b554f0c72,235,0,0,0,0,235
1227,0xbc70f694eac067bcf21fd792e1af3f50050309f4,234,0,0,0,0,234
1228,0x649df9d67d218adc25e5896d222d12d6d3b19827,234,0,0,0,0,234
1229,0x3d15f04d93d412f7ff55a667809d3219faf8374b,84,0,0,150,0,234
1230,0x518e09fb0204008d5b503d55e23855d3b2668779,234,0,0,0,0,234
1231,0x924b791f33822addf72ab8c1a5ea454d458fe8e8,233,0,0,0,0,233
1232,0x30e0272a0fbba9bee189622e1964c0dff73b5953,233,0,0,0,0,233
1233,0x422712d90661909b5f7bcc255f173750a72be660,33,200,0,0,0,233
1234,0xbecb8de262db51300d5992ab324759650fe51061,232,0,0,0,0,232
1235,0x0132d45b76710d5055c4cefa4163c98291f32e62,231,0,0,0,0,231
1236,0x977c425a4779edb5fa24fec20850b6e1df2da6ab,231,0,0,0,0,231
1237,0x94820bf03e87f02b2c79607668baf9a608865149,228,0,0,0,0,228
1238,0x4323c50d70c39231cf264021ddaacce7d02fa834,228,0,0,0,0,228
1239,0x367bfa8121f7e4a59d5878be3e1cc4634f3d705d,227,0,0,0,0,227
1240,0xed878594b9e18d8c184acb3acb1812766c4e922c,65,0,0,160,0,225
1241,0x09a043874694c0576c66b2a37522107e2e129b52,25,0,0,200,0,225
1242,0x6aa966b0fc06fb5ad041b005cd312fe2cddd2052,65,0,0,160,0,225
1243,0x52b6b296165ea6af522fb4a6801ccc11ad91f3be,224,0,0,0,0,224
1244,0x160b4b8a86e93e7208eb73f7ac62e3397a02d6eb,224,0,0,0,0,224
1245,0x099ea8f1190f82ae4fadd73970cec1bced0b53de,223,0,0,0,0,223
1246,0x604ad910d0208e3ef7c1c79e94522baf7cc680da,222,0,0,0,0,222
1247,0xff319e5e7206a28daca3b540e5d30420110effaf,220,0,0,0,0,220
1248,0x8b2ee09dfaa3d898f9256fcda5ff4b7292f3bb0b,219,0,0,0,0,219
1249,0x8faba3912951e0cc0abee1f7d4115405f9bb3109,216,0,0,0,0,216
1250,0x53f9a8d4b527e219988deaf5d8246a4427eb2e31,216,0,0,0,0,216
1251,0xeb5d6645891e004fcacd169c9d21517c9978fcab,212,0,0,0,0,212
1252,0x1f8c8bb4971c42e441e2fc3662bcac89052d4373,112,100,0,0,0,212
1253,0xb4bf8433abc39e793cd3c5172eb079322b8a8c95,50,0,0,160,0,210
1254,0x4fce560cc4dbbd1f19535247051ba802baf2dc7a,208,0,0,0,0,208
1255,0xb2b8809cb9e81de7595f21cd65c4d7d36e592d0d,208,0,0,0,0,208
1256,0x1292183d5fd2a430c5d52a31c5fa42ce27da25b5,206,0,0,0,0,206
1257,0x747010709a3f7d5484c0bd313f6d01ad12735480,206,0,0,0,0,206
1258,0xf7431fdeb9603bb4fb443b88dec7642e853079a0,5,0,200,0,0,205
1259,0x7ae73a765e99019511e84f3d7028d7ca27126bcc,104,100,0,0,0,204
1260,0xc70fa4079ab57a7d96121175ffa914ce0c44f851,204,0,0,0,0,204
1261,0x7726e085d9a0b79e9918fc1e8a63e19bcac656d2,203,0,0,0,0,203
1262,0x108e3b5cf2d1c9121b37602d22adfaea38f890ab,46,0,0,156,0,202
1263,0xb5be171b53954ab58dd42c2a87ba5cd87142e884,201,0,0,0,0,201
1264,0x837253fa2d3f43a07dd8a8ce2c081aad8f670d5d,0,200,0,0,0,200
1265,0x1623fc6a841f243ae0ea64ab0627a4a96dfb1d08,0,200,0,0,0,200
1266,0x400c2789e54c1d7dccb2898097d4197511ae919a,0,200,0,0,0,200
1267,0x25d2ec39c7aeee97b84fbad3fe18247aaf5bb283,0,200,0,0,0,200
1268,0xb86d9def49b6a88a59a3a4737cc79bedab259663,0,0,0,200,0,200
1269,0xa3955e89f063e3691e55b5e095f2f11a3a0e5801,0,200,0,0,0,200
1270,0x7aa0eed7a460f78b899a3b6385c35eb0f47fb23f,0,200,0,0,0,200
1271,0x58607550a6fc904c4923f508309b366f358a91b5,0,200,0,0,0,200
1272,0x91873699ca10d7e572bec30db43ec10b52e460db,0,200,0,0,0,200
1273,0x81ed1fc2624ffe219932e8f0cc62b043c6c6092e,0,200,0,0,0,200
1274,0xedf6459082418b60ceb906fb0e165a6a17c714d7,0,200,0,0,0,200
1275,0xcc232d4357a6a2061433b47b53d254cd38490af1,0,200,0,0,0,200
1276,0x490c1487ba7b41afa345116892235f77953516b9,0,200,0,0,0,200
1277,0xe1b89679cb22488020ceaf53706e812c06cf4605,0,200,0,0,0,200
1278,0x38e964f51683cbc3e316adde5fe12c98910be3b6,0,200,0,0,0,200
1279,0x2d64039795cc76d542f296f0382382a7e5abc0b3,0,200,0,0,0,200
1280,0x7b87dbf663af24e3755196f42cdfe6bb42de659f,0,200,0,0,0,200
1281,0x3e1c6083e16052835c410916c3fa4f97b4849d12,0,200,0,0,0,200
1282,0xd3901aad04e892f8dca7ae2c153496a211728477,0,200,0,0,0,200
1283,0x0e279033ea931f98908cc52e1abfca60118caeba,0,200,0,0,0,200
1284,0xbfde97f52f50ca7731385137ec7bb62be60a8ee5,0,200,0,0,0,200
1285,0x987ce913708d877cd88c6c33c4e371da9e4b105c,0,0,0,200,0,200
1286,0x82512fed7d39d2157921d1eedfbff11ff707a9cc,0,200,0,0,0,200
1287,0xf88555ca848b66bd79bca1ee43644b4fb8060917,0,200,0,0,0,200
1288,0xec98eca15f1afd359a501bd9c59d65369e9d9d28,199,0,0,0,0,199
1289,0xadd7e05faa3d2c6c69958c7d8d9bae9ba9bca868,85,0,0,112,0,197
1290,0xdfea8987ff8581b80f3ca4b9c27c973ec68207da,197,0,0,0,0,197
1291,0xc5a2c1d170426fc2ac5fdead753cee3801f03348,197,0,0,0,0,197
1292,0x8ca1d0e74b7e7d0a624bdb234cb16093555ae46b,197,0,0,0,0,197
1293,0xa80aefcbea2a6dfb2e6d2a6da9756625b53df217,93,0,0,102,0,195
1294,0x86b4d38e451c707e4914ffceab9479e3a8685f98,195,0,0,0,0,195
1295,0x6ecef67478d2190d3d49d52693dfba7cddb54da3,194,0,0,0,0,194
1296,0x1c45d06592016ed8b4c0601c00f38fff59f2fccc,193,0,0,0,0,193
1297,0x700cd3be4343bd3bbd8e3ebc19d583353582a7ad,191,0,0,0,0,191
1298,0x90288121aeb294ed88bd709bf6de58a476ad7808,191,0,0,0,0,191
1299,0x21bc82e6406e216669d75f8e2f84e73eb6fc2679,90,100,0,0,0,190
1300,0xcb80cf133f59af0445a390bd1bfb5063ec04e7d7,189,0,0,0,0,189
1301,0xa0a17a7e7d701132b7022e2a7cd95085f094ac6c,189,0,0,0,0,189
1302,0x9d79f12e677822c2d3f9745e422cb1cdbc5a41aa,187,0,0,0,0,187
1303,0x6f3115bb85efc45ea3a5e7b866a772144938973b,187,0,0,0,0,187
1304,0x8ba8f5a1fc0ce1ce3497ed27ea601cb1e9996765,36,0,0,150,0,186
1305,0xc96f547e6fdc7087ea23dc681c30aeb6536a1e84,186,0,0,0,0,186
1306,0x3d30df5e81989360ed6c92a61853aa387c8d56be,184,0,0,0,0,184
1307,0x098c819b21881bdf5a03749f068b8771b4def213,133,50,0,0,0,183
1308,0xf80af6921c342cc22bd1ae57530351da2732f2b0,181,0,0,0,0,181
1309,0x42f422624d9e4db95a8b0d170e2c6927b204810a,0,0,0,179,0,179
1310,0x332a70f0e3f7222dd4b3a5a14126fd8d9bfba80a,179,0,0,0,0,179
1311,0xf138984bd659edd8de38fb2febedae8bed5e0255,28,150,0,0,0,178
1312,0xd0ad3617b53bd39d27064f48121b419a8c58aa13,178,0,0,0,0,178
1313,0x5144a964e82f030b77b16937c2ce167b7b45de27,176,0,0,0,0,176
1314,0xea401e19a817e8fc2a10d2cd8c561448d4fc9edf,176,0,0,0,0,176
1315,0x2efaece92bbe100c0dcdc8b46bd00640b0c5287e,175,0,0,0,0,175
1316,0x7383e767ee2a8cb39b7703cd61dcde2bf127fdad,75,100,0,0,0,175
1317,0x5c80445afc7eb52c5ecdcda133e8fd4676697c3a,173,0,0,0,0,173
1318,0x098dcba18e5aee8a45ede1772e910c79d28031ad,173,0,0,0,0,173
1319,0x98b63fe0ff5c9ea408ffc7c9fbda9f2852aa90b2,169,0,0,0,0,169
1320,0xcfc6bbfb3f8584c7ff0aeb032172ee472ed4e7dc,169,0,0,0,0,169
1321,0x5fb86de87ab6dd08c1b1face8c2528e3308b87af,169,0,0,0,0,169
1322,0x31716f6fcc382f53671155eb633de4997b021293,168,0,0,0,0,168
1323,0x966e129d11ea50d18c4161197cc4c9c12997ff75,167,0,0,0,0,167
1324,0x0889f4f579bddf25cc9b56e8341d176a7e8433ca,167,0,0,0,0,167
1325,0x633efc0b3ff672ed2482d798690fbc57cf71e53b,166,0,0,0,0,166
1326,0x9f67b28a586d62d3b629d49ca4e480055a71f8f2,166,0,0,0,0,166
1327,0x54e441232448a44f3e39270c33d848865d0498d4,165,0,0,0,0,165
1328,0xb7e53c916b1c37270456c854684bb9c35f3d3e31,65,100,0,0,0,165
1329,0x2d4224a93e71f0a666c9ffeb8d8c2080571c486f,164,0,0,0,0,164
1330,0x6670c4a13b5f3b36f32621c76525ebba3487744e,164,0,0,0,0,164
1331,0xb854f6983e0218449a3e7119c52915111f307e5f,164,0,0,0,0,164
1332,0xd461df10bea2153c8b0cd4d20b26870cdc72eae9,60,0,0,104,0,164
1333,0xd0c07fc1e0df70f3c8e51bc3ec03c0b92e7d3102,163,0,0,0,0,163
1334,0x35ada22fc52c6daaeac828adc5c72b45b05b40c0,162,0,0,0,0,162
1335,0xf4ef562fbf27d62f782be95f21b31f0fd7d4ed0f,162,0,0,0,0,162
1336,0xa0b5446a7bbab5ea828f2ac5f3df59ecbfff4c1e,161,0,0,0,0,161
1337,0xbe6c422a7aca6a352895c2a2356e735e3f4f402c,160,0,0,0,0,160
1338,0x4fa3db95d32fa11a052b09bdfb0a82641c824c54,158,0,0,0,0,158
1339,0x83ea0e27b075e76b4d11d412f9cc01b40ccfc0d0,157,0,0,0,0,157
1340,0x5d8640886ae923711c64f017b3dc835a67722110,157,0,0,0,0,157
1341,0xca907ff5608b53bfaf9f905ec27b9b6664cd576c,157,0,0,0,0,157
1342,0x6cc475445332917fdb999edc36bbb92411004b49,156,0,0,0,0,156
1343,0xb9532e63ed0dea7a699e84264bce5f97d7d30234,156,0,0,0,0,156
1344,0x2c671b86c24f4472bffd9d8be46aac4269e20e7e,154,0,0,0,0,154
1345,0x2c43625fd2cf9246b0a6c0af6813d1c8b6ce0e1a,154,0,0,0,0,154
1346,0x1d21045d3f78927d149aadf7bdd84234a0f70104,54,100,0,0,0,154
1347,0xf2d29bbd9508cc58e2d7fe8427bd2bc0ad58e878,153,0,0,0,0,153
1348,0x3d0a8df7eac3cf3ec06b880d3aa1d2170b66404f,22,0,0,130,0,152
1349,0xcd689beb059d96ca51c8281d50fc3150c24ad9c2,151,0,0,0,0,151
1350,0xace718e1914f4824a3832fdf74d5279c168d53c6,151,0,0,0,0,151
1351,0xbabcdad3b3cda6ca7041a87253529d49658c7d59,0,150,0,0,0,150
1352,0x3c391f59e33fc6a52a0f72cfdab0ab38e4d7ad19,0,150,0,0,0,150
1353,0xef53dbe48368d5d427346ffe59bac0d73605da1f,150,0,0,0,0,150
1354,0xe7c30f850efa67681c7e4ae2a2cb0fcc25a7eaf9,0,150,0,0,0,150
1355,0x60ac84d6c11529b3b03db64c00c47f7d8d4a2341,0,150,0,0,0,150
1356,0x368a77e263bf71390efc1885fa747e70b0a738a3,0,150,0,0,0,150
1357,0x9ef307c0a4afddc315baa9e5e8cb0e1ab6471e38,0,150,0,0,0,150
1358,0x43e8c9cac18b19f5eb7605c438b8386aab012c2b,0,150,0,0,0,150
1359,0x8e74ba38b5cafca0a00100e4070581c91332abd6,0,150,0,0,0,150
1360,0x965fc3cfc9ed489e421b7c55a5c02d75c254f5d3,0,150,0,0,0,150
1361,0xda104377d10aab4c7de7d49f772905f43ec85589,0,150,0,0,0,150
1362,0x3f2a008f7955aac8635ef27112d873c33fdf9a73,0,150,0,0,0,150
1363,0xbc8492a5815218920b0c28fd558d427d77c91ab2,0,150,0,0,0,150
1364,0xd95175f670d3586a7fff1e0678e9fa5793ea48db,0,150,0,0,0,150
1365,0xa1bba0bc0c6010af21d74ec2d889cedfca8fb6ac,0,150,0,0,0,150
1366,0x68fb1f3202c91c043268cb47b1d2b0ffdba80002,0,150,0,0,0,150
1367,0x29c3ef7abbe8f1897719b0aa3af191f5bb562d69,0,150,0,0,0,150
1368,0xc2fe4deaff7bf8cff12fcf3139aa950cb902a717,0,150,0,0,0,150
1369,0x3e1df292c4aeb7b72cf0d4f1319d609ccb614284,0,150,0,0,0,150
1370,0xee8f7ac7afdd357609c81484fb6f527b50744204,0,150,0,0,0,150
1371,0x7691f281becf940d8ac73a9a39d86959ea96b475,149,0,0,0,0,149
1372,0x55edf6e986c3d21f5ed1ddb87237ba293fb40814,148,0,0,0,0,148
1373,0x1d484ddfa49a3df44e3d0f5ffe3e194045bb0869,148,0,0,0,0,148
1374,0x816d51cf7d44bfc804e35ec89b8d9d619652eca8,148,0,0,0,0,148
1375,0x23bc0738051397035e49d3efbd5aa94f7281a140,148,0,0,0,0,148
1376,0x30da9add5a6c4480d79495fb195a50ae97eca4a6,46,100,0,0,0,146
1377,0x12b1591b15851230839a20dfed1601ae42ed94ed,146,0,0,0,0,146
1378,0x964ef3218d8815ecff89e0af40098514d05ba1ce,146,0,0,0,0,146
1379,0x015ad8384cdd86ae3dca67eb713a37cd191f97d6,145,0,0,0,0,145
1380,0xa30ba688b4cd742fec73d4691eff933e6b837bbe,144,0,0,0,0,144
1381,0x687294569867f8138519763a19a761c20e032c58,143,0,0,0,0,143
1382,0x551c5770ab4ae8b4d2158ae96dcfa9150bb0d7b0,143,0,0,0,0,143
1383,0xc0dc00ce6bba603fb32f6a55639c9b796ca1a81a,141,0,0,0,0,141
1384,0xdc8e2d61b358041d5128f25355d716708a983e45,35,0,0,105,0,140
1385,0x685772bd850b936b48bc18f261ed56602d6af2c4,140,0,0,0,0,140
1386,0x23e468b934eb234465537af6e96680a2b48d174a,140,0,0,0,0,140
1387,0x161d93e3c2b795011c6d6d0542ba81de643426f2,139,0,0,0,0,139
1388,0x4d282b79ccc3ebe0eedc4010177c5b5b691f21b4,38,0,0,100,0,138
1389,0x189ffdd08e82721204729d1eb9db33384492abcb,13,0,0,125,0,138
1390,0x52bb30d6d9d85b69aa869e572d902db8b0f6a334,137,0,0,0,0,137
1391,0x20df3b6724dfead485b95e9c2568183ded217051,137,0,0,0,0,137
1392,0xfd7a028a6197313889fc83376c3edbb333f9808b,137,0,0,0,0,137
1393,0x43363f4132587ac47add0f3b5fd918801e8eb417,136,0,0,0,0,136
1394,0x5dea60eef2bfcef3a808a219b562145d1b80bd7d,136,0,0,0,0,136
1395,0x6ed8f9798ab67ce84bbf7d538524d6316d32c297,135,0,0,0,0,135
1396,0x31d6efd9aea795b8bef68dc39f5997633e9cdd00,135,0,0,0,0,135
1397,0x198422d4b8c69d830cfb3a92fa95f976b982f8c7,135,0,0,0,0,135
1398,0x22710a7d9653fca297ba84452ea2ded8c21990ce,134,0,0,0,0,134
1399,0x2fbd45c15fd7e3897b355a4d0403511334d2f5e3,133,0,0,0,0,133
1400,0xf83d7a4dc0fc5a064720b4f5781fe8435b214683,133,0,0,0,0,133
1401,0x64baab2d623ae1fa17ed3754bcc8cf3e7f460b4c,133,0,0,0,0,133
1402,0xb245a959a3d2608e248239638a240c5fcfe20596,133,0,0,0,0,133
1403,0x3c8b480dc037d7cbc3e5317b4b2097906e0fa345,133,0,0,0,0,133
1404,0xb9c2cb57dfe51f8a2fb588f333bdc89d8d90ca9b,132,0,0,0,0,132
1405,0x2c2cd3812ea5f3233f7e4c77ae55bd2bd6e75e0c,131,0,0,0,0,131
1406,0xee70d0bdf15b2ceaddfb09fd1c743be293abe37f,131,0,0,0,0,131
1407,0x8ed876fded3699c590be3e12cef56e23376eff3b,0,0,0,130,0,130
1408,0xe8771a6247f9b9ccecce195d12e4afb9abaa847c,130,0,0,0,0,130
1409,0xc9080ec4caea599dca62f41f416a2280be9d3adf,130,0,0,0,0,130
1410,0xe106b7e5fd62f93b64deb728b97b95cbb3e25418,129,0,0,0,0,129
1411,0x85c4a560446563c1bfa33afc636b54de5a3a3335,128,0,0,0,0,128
1412,0xe55137d967f55ae5bd967ffe4337e6aa57663e07,128,0,0,0,0,128
1413,0x68cca4f9cbc5219581536c1e18f2588bc0b13911,128,0,0,0,0,128
1414,0x2f22eed284d130c1981a3456b5fc604104f0bf26,127,0,0,0,0,127
1415,0x54ca4c90e045d7deb3c49569701138b93cabe48b,127,0,0,0,0,127
1416,0x9e77d5adaf102b574a597dbcb474ec21bc3dfabc,125,0,0,0,0,125
1417,0x367c5f0dcc7e5deaa3afb3bd4b6478bc868ad5e2,125,0,0,0,0,125
1418,0x4b2ccbf11eb63f21fb02da5dfdf4ab8a79453639,25,100,0,0,0,125
1419,0x06de4d1eb14c737d270ce8aab4295411ba51f29e,125,0,0,0,0,125
1420,0x66297c04f9dc4cb6a3e2b08af4bffdfb337563d1,125,0,0,0,0,125
1421,0x967f5e01baceb5def9fbd8663e98e783a93d8bba,124,0,0,0,0,124
1422,0x55e1037ab240098763c3dd374fe723ac3b5b86a6,74,50,0,0,0,124
1423,0xe2bdae527f99a68724b9d5c271438437fc2a4695,122,0,0,0,0,122
1424,0xd14827a835b53011f8058df335c59da26f7c9a96,122,0,0,0,0,122
1425,0x993718d08baf1c02d3be995c0e3619766ae6dcbc,21,0,0,101,0,122
1426,0xcb97592071fa186ed4c8d00dcd1d50f4145c1a80,121,0,0,0,0,121
1427,0xae7f7ef71b0317b53ab088c2b4c3a706a4539915,121,0,0,0,0,121
1428,0x6dc2d98599c8057a026910fae5517e293432d6e4,120,0,0,0,0,120
1429,0xdf541ceb9815ab6621a85f1e4035f15c652ed6cb,120,0,0,0,0,120
1430,0x4a8b9e2c2940fdd39aceb384654dc59acb58c337,120,0,0,0,0,120
1431,0x8647271112679a680bd2584902dc627e6f265e06,119,0,0,0,0,119
1432,0x20bd84fa0bdec2c4da7e8a9b7a2752ad6e791efb,118,0,0,0,0,118
1433,0x07b162ab00e270bb05c2eb7e6f3455560210d125,118,0,0,0,0,118
1434,0xf8d189386fb4ea01d5d760ae152e63514644ca3f,118,0,0,0,0,118
1435,0x66d0b2f496aeda911f6083529aae89d0b3fa9cdc,117,0,0,0,0,117
1436,0xeb32fca1354459f2f17535036d815033f72e32e1,117,0,0,0,0,117
1437,0x68f2e1f5d5dbae1206e67ced44e778a79ee201ab,117,0,0,0,0,117
1438,0x0de978dece831b71ba126ffe9efcd66bba2df136,0,0,0,117,0,117
1439,0x585da33717decbe3f8eb8aafa4cd3ffa22aa10bb,116,0,0,0,0,116
1440,0x79adea6499f08a58438b9828913fdbac98386605,116,0,0,0,0,116
1441,0x5aa7510e8dee59209514b47942ce1878ce8dddaf,116,0,0,0,0,116
1442,0x8a7ea886e45656ec1697c4a5e20450cfe8d62a83,115,0,0,0,0,115
1443,0x93b1f9f85f24fb06d440f6fcd5d3abdf05e68088,115,0,0,0,0,115
1444,0x4c7664614aba3710d827ad5af7a47161a83f2242,115,0,0,0,0,115
1445,0x6993c1b274ca322292635e45bef4f99afb202e2a,115,0,0,0,0,115
1446,0x0dfb6a45da56c98b3407a2991b12ac5f913706ce,114,0,0,0,0,114
1447,0x6a2ed05e1bdf600a13d7944835352b7319909b74,113,0,0,0,0,113
1448,0xa476686a7f74d2fb28c23ed3f59aa45557210577,112,0,0,0,0,112
1449,0x9cddb0fd57c9598963e8a3735f9a70f7f0212146,112,0,0,0,0,112
1450,0xad30a419351c0960028109b524043f6e92606976,112,0,0,0,0,112
1451,0x811ea54c975044ab74396a632ca127b3ebd15702,111,0,0,0,0,111
1452,0xd9504b6b66881b17e62fb22d33c7cda648fe7f3d,111,0,0,0,0,111
1453,0x89dc32c27aad74ce78c592aa08365de8a208ec80,111,0,0,0,0,111
1454,0x9fe7049aa469d54c4732a5f4193475cdc7aa54e3,111,0,0,0,0,111
1455,0x53fa7673371d5c3f033265671f67434e023512f6,110,0,0,0,0,110
1456,0x86e3f42306ed8cb3ff0287f6ecc9a902d68855e5,110,0,0,0,0,110
1457,0xc53f3449431fe47270a3e8447f76c1ff28aa4e21,110,0,0,0,0,110
1458,0x1107a56a15671ed9a264c28a4fa9ca5afa18f553,109,0,0,0,0,109
1459,0x4b0a238a01ec57524e3cf423c7c552c1a0b72090,109,0,0,0,0,109
1460,0x77e4da86c3a075cd46284710065e34b4973663d7,109,0,0,0,0,109
1461,0x4a79dc21354fbc4cff4653a0d6f3dda51fb0c9ff,7,0,0,102,0,109
1462,0x87ed1d1aa7b7e52db862f85f585e0d233529d4e8,108,0,0,0,0,108
1463,0x0fc6894b865f4e9ecd9d8d43f57766adc0e8f745,108,0,0,0,0,108
1464,0xf6d021957bcf250ed522ef1a64a6367bd5e34b16,108,0,0,0,0,108
1465,0xcda54f82379d6d33b2a761c0f7f5fe248dd87710,106,0,0,0,0,106
1466,0xc75359e231816a609434c940affcc49953dbd7f5,106,0,0,0,0,106
1467,0x4f5e7f5c25d57f3414bd6d464740a9ee0be16e4e,106,0,0,0,0,106
1468,0x90f25ad795d40a1625740d49299bec5c022eef9c,105,0,0,0,0,105
1469,0xa04bf5542cf8973bfc14ee4bf73c4032879dd0bf,105,0,0,0,0,105
1470,0x0e2bfc70c51774c21ad70b0926bbe854a34cbd37,105,0,0,0,0,105
1471,0x12efe885eb42830cb16929878298ee21291d9b02,105,0,0,0,0,105
1472,0x38782da9767f843e4e2dd279ca33c991e49fcbed,105,0,0,0,0,105
1473,0x5a96c56f26ee3ed08534326cd01601c7676a6430,105,0,0,0,0,105
1474,0x6d67d20985bb81cc70cc737f71c9e3e49fb701d6,105,0,0,0,0,105
1475,0x58cee6fcc00671dd8ef315b63fc008adb9547f93,105,0,0,0,0,105
1476,0x39797255bad64c29322a04c18b918bc3ed669d4d,5,100,0,0,0,105
1477,0x5f71f5608cf62acafd799791a64c74ea21f247d8,105,0,0,0,0,105
1478,0xc53307052c6406be0c67fb882a3fc2b3c20797e7,104,0,0,0,0,104
1479,0x2f7670e702dc14c87c7690701e4442bf5b474a50,103,0,0,0,0,103
1480,0xfb13d30424b5bf0487bf04b9ca590549d9da1a37,102,0,0,0,0,102
1481,0xb27fb97fccf51fbd1c9b33dd0f8b8fe9a4dab040,1,100,0,0,0,101
1482,0xe30d4a53e3a4f835e504574192987988c420c7bd,101,0,0,0,0,101
1483,0x7ccad45fcbbaecd43f960c5af4e82ed2a0021d7c,0,0,0,100,0,100
1484,0xd44d49616a41e430db0008658fa3da3199e1431d,0,100,0,0,0,100
1485,0x219778534c0259b5f0b79a86517739754fcaa143,0,100,0,0,0,100
1486,0x7af6086ffd4a55c9036673e7f0cddd1dd647221c,50,50,0,0,0,100
1487,0x63dd39aec53c7e50c023868f46bd1391e54988ba,0,100,0,0,0,100
1488,0x8fabe1273aaac9bd0b410171c31f4f51c20e6698,100,0,0,0,0,100
1489,0x380a8c10008c00fba276c3ac4dd3b05a6c3f4bf1,0,100,0,0,0,100
1490,0x49c4c001b58cbd710251b418027a59ff805ea981,0,100,0,0,0,100
1491,0x359e50c605a15a517fcf4a8db0beeb7c34b22374,0,100,0,0,0,100
1492,0x4314fff933394b0b6ebaab886b1e14cfff0fd657,0,100,0,0,0,100
1493,0xb2e7e393e8c6dfe9c311ce786e1e68459253839c,0,100,0,0,0,100
1494,0xc1c54223f78492248b9d73b344ebb435fa29b331,0,100,0,0,0,100
1495,0x986c38c8f674d52b6bd05eb72b79cda54310ed08,0,100,0,0,0,100
1496,0x9d8179fe4ff6dbbddee2f1c853f6ceaa043ee23c,0,100,0,0,0,100
1497,0x462fcc4b3fc64e0dfd751424bc3b070d79efb300,0,100,0,0,0,100
1498,0xc9e09eb8b3def0ac38a1611d4bfa4cf65d1050f6,100,0,0,0,0,100
1499,0xb4f50bf86abf21eb81ef90e0c8db19b156027145,0,100,0,0,0,100
1500,0xaceb5937e4057139ca1deffe9eb726d9ae6000d4,0,100,0,0,0,100
1501,0x223a1b8d6f2ef8d83e0df91542b99601bc558e2c,0,100,0,0,0,100
1502,0xe95ab07a55e8489fe8e81e3281c8b3fd95c7d8af,99,0,0,0,0,99
1503,0xe8c0fe3699db673486c391a4eefa5a18c7cfd4d6,99,0,0,0,0,99
1504,0x607ebb012d5dfb73adadc0101364ee931dd2a29f,98,0,0,0,0,98
1505,0x3c2c38ae8853a99095192512cc2e7fa4079af222,98,0,0,0,0,98
1506,0x2ad09b2d2744de5f138feae2ef4f0fc711a574af,98,0,0,0,0,98
1507,0x07638e6bd8ea54642ec19a0209c66e74cdb4e0dc,97,0,0,0,0,97
1508,0x524d9237d64ff3910c0588ae8d5b8ee775c7c0ad,97,0,0,0,0,97
1509,0x520c1058ccddbdcf428cc4b99e6c669edde487e7,97,0,0,0,0,97
1510,0xd71e4237e940198f8b1a4e81a9e010c957d2dd01,97,0,0,0,0,97
1511,0x69cfabf25bf4b629416bf589e27f37a8a8fe0a34,97,0,0,0,0,97
1512,0x2768391866ec186584cb94f21c28dbef1b8154d7,96,0,0,0,0,96
1513,0x614b49fa829658bf61a1c5e52583df4a15670eba,96,0,0,0,0,96
1514,0x339399b830383c94f76343cba6d2465bbdeff4e4,95,0,0,0,0,95
1515,0x6507db73d6ade38af8467eb5ab445f224cedaf38,95,0,0,0,0,95
1516,0x5d5d965f52721de9238dadf6366b42bfd7d721e5,95,0,0,0,0,95
1517,0x552544565b93cca46e8a9d11f4a71a78c6d06f36,95,0,0,0,0,95
1518,0x8b8fd5cea96c61940778fe3ded6d2f2131f27385,95,0,0,0,0,95
1519,0x7d06c801b21c025b443f30bfa6fff37a6aa8f887,44,50,0,0,0,94
1520,0x749db7849622b7d91d5d5219a3a459e55805c7b9,93,0,0,0,0,93
1521,0x0321fed3af11c0dac59578c48f60982001a7f3d6,93,0,0,0,0,93
1522,0xaeb95e7b3be6d16bfac4cbb636fbbf5a73b13e28,93,0,0,0,0,93
1523,0x613a1df3efb8a6b9e20f0e477d14b745547ac4c9,93,0,0,0,0,93
1524,0x027e94ca2afdd5a90731526eb20b017734929fd9,42,50,0,0,0,92
1525,0x0eb6ed427e14e42dc01cb266943b22db5231f14b,92,0,0,0,0,92
1526,0x4b045408c9574e6b3135369b6b9dde79e42a1fbc,92,0,0,0,0,92
1527,0x78c97e4558e37bd33f68edc1184fd40c08df8bd6,91,0,0,0,0,91
1528,0x4200913251d8e55f5233446f5cfdcfe64668500a,90,0,0,0,0,90
1529,0x17eeef392094bca35da5374aa16f82873aa8644d,90,0,0,0,0,90
1530,0x77f1f02101cf89268f451184b541a2fbcc436a09,90,0,0,0,0,90
1531,0x12a3da623143c7d77f81c0a32439d58f9ab0f15b,90,0,0,0,0,90
1532,0x27831c1833e661cfb41701278a92d064d03a69b1,87,0,0,0,0,87
1533,0x62083c6a507966e70e244c946d976b79e02add9b,87,0,0,0,0,87
1534,0x8c1a4de2fff9ff7279da00c7277e3300f45b85b1,87,0,0,0,0,87
1535,0x5f0e7c0f435c6c280b3d6fd24857c3f38a9aa1d4,86,0,0,0,0,86
1536,0x8e8db32d0c15116ac33ea8d1ae56747b94883e60,85,0,0,0,0,85
1537,0x0c633753fa7a8e5143176090aaaf0f35b12cc60c,85,0,0,0,0,85
1538,0x0467529142f1eeda848c4722e026c0b753e6aaaf,85,0,0,0,0,85
1539,0x54cb44886610eff9334ab24397ba3c7919ff7d71,84,0,0,0,0,84
1540,0xd18b5daac309ec007fcc51a9738832beef420603,84,0,0,0,0,84
1541,0x45b34ed165c19eb24d549bd34643393ed3039046,84,0,0,0,0,84
1542,0x5b14157cbbc253a19247b9372d464e2edf2b9074,81,0,0,0,0,81
1543,0xfccddaefe80044cb624741f7206cbd24706b34c3,81,0,0,0,0,81
1544,0xb0dc04166835b9429345fa72c70c9d52959de57b,80,0,0,0,0,80
1545,0xecebdc4c57c1afc053c7b4ff45ddc4300d4a20c8,80,0,0,0,0,80
1546,0xc6f07f765c1ff6751504a340044b03e37fff4a7f,80,0,0,0,0,80
1547,0x80771788286195c70d058044eacfbff7b8d11949,80,0,0,0,0,80
1548,0x59de14303fd101c64676da4d6471d82e0b7fc86b,80,0,0,0,0,80
1549,0x1f0a91b7e363ff82378583fc37f1e00d8917706b,80,0,0,0,0,80
1550,0x9cd368d315e7c5a16ee27f558937aa236b4aa509,79,0,0,0,0,79
1551,0xb3a8d22d29bea866dd09186b9f1c9dfa28d61eab,79,0,0,0,0,79
1552,0x6ac2681a311f49c729d1ec194d99936ad8652f71,79,0,0,0,0,79
1553,0xcfceceac930da8393f0a1a92eb6f41589dd8e1d0,79,0,0,0,0,79
1554,0x231e72b2c56acf33fdbfd31173ddc3f31c926a77,79,0,0,0,0,79
1555,0xba188c418d95145d73f3706b6d436249fa5cbeb7,79,0,0,0,0,79
1556,0x955e172657dc43575ce8a2a56308579a3a3bac6c,78,0,0,0,0,78
1557,0x4f2c88832ca6e0780e1368e786eb46ab800d6f05,78,0,0,0,0,78
1558,0xf8c7e2e7f80053836bd30a4f2461269a6837f1ef,78,0,0,0,0,78
1559,0xdcc4c0ee05751c0e2ff8e6da9f80df864809c42c,27,50,0,0,0,77
1560,0xac48b8f22883ddd8bdbe0bd516c528e72f43c77e,77,0,0,0,0,77
1561,0x414ae75fc968d90fa82f0402a55603d1b5186c37,77,0,0,0,0,77
1562,0xa742e2cb02bb41db297fa2214f64581e4f8c9248,76,0,0,0,0,76
1563,0x08ace91217285e4eeec5322974861a5420126989,76,0,0,0,0,76
1564,0xdc447ec88c5f092ea2767f127e3fe0e569384f6b,75,0,0,0,0,75
1565,0x021c26e07a6e2cba2c3eaf1c7e8cd7708bdf454e,75,0,0,0,0,75
1566,0xedff655db52aa368f71aec60b37c70675bc6363c,75,0,0,0,0,75
1567,0x46baf40f594348af9dc33a46cb6a5f1a1255eb36,74,0,0,0,0,74
1568,0xd79ac04f0ae05821edc7b703fc7104d1daa0cf06,74,0,0,0,0,74
1569,0x06d643b9ee73de07ade8b5c9fd520fa2aa28262a,74,0,0,0,0,74
1570,0x1bbd5a0625f7dd53ad846adee4e7347bbfbcb363,73,0,0,0,0,73
1571,0xc4b952f16291bcb110ebeef1879e3df073ad16fd,73,0,0,0,0,73
1572,0x969e521f7dd9533eee5c69c78f79c6a6a6e6df7e,72,0,0,0,0,72
1573,0x8cdf422996b6b5f65bcc05a18cd3b6f008391caf,72,0,0,0,0,72
1574,0x19428885a39a211d85fcd09559dd769a26f70896,72,0,0,0,0,72
1575,0x5e8777a583ecf59839f02a6967b8dbadfff47e30,71,0,0,0,0,71
1576,0x8b5c0de9c1f283079c6734aea3f76dab72b5a5c8,70,0,0,0,0,70
1577,0x776f0ff2f6e134f1b894ce478271451f9f1de0f7,69,0,0,0,0,69
1578,0x2a73543f2adaf1044b86389872e3c98ef3ccdb75,69,0,0,0,0,69
1579,0x0119f846b06211063f06b7428d6a4926fcddb0ca,69,0,0,0,0,69
1580,0x00dd8dbbae8f9c33df4e641e261455a44a04da45,69,0,0,0,0,69
1581,0xcc2bedff53d4134a1c07825888011c5a567e4f79,69,0,0,0,0,69
1582,0x476be6b54668fdaf31185c5909cb8703fe086f34,18,50,0,0,0,68
1583,0xcfcef01f0aa3cac7a58be95e46e4c79db757740d,66,0,0,0,0,66
1584,0x37b04171aad5eac14001bba97ee166ad93b03320,66,0,0,0,0,66
1585,0xf8e227600d765eac1aebec7ed8d01ebb61ffbb1e,65,0,0,0,0,65
1586,0xe36812194a58b34df1bca110daab41314a29316f,65,0,0,0,0,65
1587,0xb01d0114e834c3f3404abe78453d794c692657b4,65,0,0,0,0,65
1588,0x6a0ca80be6f46965cf48ec5175e8b168c0159987,64,0,0,0,0,64
1589,0x5361c529dcfe935709f288364a54d4551f3821c4,64,0,0,0,0,64
1590,0x083a66b5958ecdefd1720cee6769835d2ff265b0,63,0,0,0,0,63
1591,0x89eb33e0a0d9dc7a8fb1cb8d759313af3c323446,63,0,0,0,0,63
1592,0x0b2dab555071a82080a731d2c47df1a0d12f0d65,62,0,0,0,0,62
1593,0x6a9d0de493573e950c12c80701f885ea2f7ee31c,62,0,0,0,0,62
1594,0x24b86fc0d47c93101df651141dfe302ec413ace3,62,0,0,0,0,62
1595,0x26223fb0e0743bdcc8ab35908350abb60f0ce4a3,62,0,0,0,0,62
1596,0x4a57583c38e84a27c4a397d49dc7cdc8cfffec92,61,0,0,0,0,61
1597,0xb2e1a6b22abfe612011d3ca6312a714cb36b2514,60,0,0,0,0,60
1598,0x2d78d0fb34ca385a59d39d98702039cf7fc05137,59,0,0,0,0,59
1599,0xd56cca57ac65c05a882f37b21c51aa79dbd8f33a,59,0,0,0,0,59
1600,0x0ad096e96863ec40962561a13e6ca48c63760744,8,50,0,0,0,58
1601,0x06f7163ddf942a2c2598c1afe37d28ba444473fb,58,0,0,0,0,58
1602,0x016cb6c8b9fcdf3ef5378b1700bea6b7eb27a1d3,58,0,0,0,0,58
1603,0x4db551327b7df0e911614352d371110db954e618,58,0,0,0,0,58
1604,0x25bbe3974507fc85a6646cb354e0b040f3212059,58,0,0,0,0,58
1605,0x3e508d23195199376e57b286a6693246ac33daa0,57,0,0,0,0,57
1606,0x0e109d4c63494f7dec2661027672474e68de7fbb,57,0,0,0,0,57
1607,0xc16bbd74ccd02cd674ef06c90ed1e2ec8c34131e,57,0,0,0,0,57
1608,0xf72edee6bcf88715d27d6b79200c1d728293bd22,57,0,0,0,0,57
1609,0x112a2b3126a7ca385c93809f8951e8707894deef,57,0,0,0,0,57
1610,0x6fc2bd2dbb41dd718da91b9ed4eea52b705b52cf,57,0,0,0,0,57
1611,0x45692a7bbf52d7913d5a17397a91a8fb253c65a3,57,0,0,0,0,57
1612,0xbd821ee7e7755831f771b2f81b9f5aa94b5f8362,57,0,0,0,0,57
1613,0x657bcdd0ed6a8b93a437e621c15161b56b20d603,56,0,0,0,0,56
1614,0xbb3f1131f5875fdd92abbcd07bd2f047cdabd8d1,56,0,0,0,0,56
1615,0x37b2afcdfdb1311694160b46a5a29b3afde41165,56,0,0,0,0,56
1616,0x4c4f04f62293eb0dda9cc900ff9947bda839287a,56,0,0,0,0,56
1617,0xc454c101afe366db826219783174a24121803e9e,56,0,0,0,0,56
1618,0x1c21c67d14742f89899f3075640fa285fb1024c0,56,0,0,0,0,56
1619,0xada51de28e1e309e4902a3a8ad62c21f03856312,56,0,0,0,0,56
1620,0x4466b949db4201640900665d54668bbba8b2246d,56,0,0,0,0,56
1621,0x00f995ba653520b42ec3f56c4bc695c27e8dd778,56,0,0,0,0,56
1622,0x9f7ae891702be71b8a42b802450a3a1b5f66f465,55,0,0,0,0,55
1623,0x9974e2d1efbb30392f0f00be7b75058f343bce95,55,0,0,0,0,55
1624,0xe069f62a3ac39e3d82c3396bab7efd65392a4b64,55,0,0,0,0,55
1625,0x5c48064a4023b0f345577579a6171895e692cb8e,55,0,0,0,0,55
1626,0x8a17606e46b23729aff7d148bdf1d301dd4d8da5,55,0,0,0,0,55
1627,0xb4885695ac18a791f3344d147a4753b886997314,55,0,0,0,0,55
1628,0x88797e18e763dfd50b8864bca56ea3612cb52160,54,0,0,0,0,54
1629,0xe6104dd98cb8284ebc001da947ba2aac50e5bfe4,54,0,0,0,0,54
1630,0xe9ed9c5a638d71b7cfd4677d9a09f94e5733ac14,54,0,0,0,0,54
1631,0x5384687d0fa15cbc25cc17f02058707c87ad5c2a,54,0,0,0,0,54
1632,0x76e8cffc4e95414d8e0be8e9ce9d19701c6343f0,54,0,0,0,0,54
1633,0xd50a06b9c8e493b3887761c53880210f7c871358,54,0,0,0,0,54
1634,0x1e740e6bd1a5e6674d2efbe8f5128e101cd00bb4,54,0,0,0,0,54
1635,0xbb43a28112f874f43f5d1726e4d62c4bdf66c355,54,0,0,0,0,54
1636,0xc9d71ffd673f5da89051c4b18938f2faa971dc76,53,0,0,0,0,53
1637,0x8c0e032f6ac121581a03df259f54de0fc02c4eb2,53,0,0,0,0,53
1638,0x4e26f82ae5760c2aaf2c66e5b80fe24ac69a0fac,53,0,0,0,0,53
1639,0xf25c2a4615e6cd1aecd131349c5b5a075acc8bb5,53,0,0,0,0,53
1640,0xd2da51fcb317921156b967e269f9c2cf367532fe,53,0,0,0,0,53
1641,0x84b71e1ad6cebb2af32ad4d9167ac307504bf512,53,0,0,0,0,53
1642,0xf74e806568a1b7e3ec604bbff7191a839f94cb5f,53,0,0,0,0,53
1643,0xde8acd2fd5f5765c2df5800de288abdedf9d5dd9,53,0,0,0,0,53
1644,0xd1eb4605af361e31806c39bba18f10d0303174b0,52,0,0,0,0,52
1645,0x65795b70f39e8367f581cd2e0ee76463d66c1e78,52,0,0,0,0,52
1646,0x45e52d2c135f6a7c6c65eb1b2d713565457b34cf,52,0,0,0,0,52
1647,0xd8016e267b71aba19f47ce411a2c0eb9ffe8d49d,52,0,0,0,0,52
1648,0xc9abba2b9f0f22a0642b523ac53024d29aa3f21f,52,0,0,0,0,52
1649,0x25a695ab0ed7d1f02e02c2b144bbab64aab17251,52,0,0,0,0,52
1650,0x9907c678eae0bc0c09413cf159580a62177182d8,52,0,0,0,0,52
1651,0xb16b4016f3ca82fae2e4feb2c6f5e8d414d274c4,52,0,0,0,0,52
1652,0x09c7533cc31fcb722471d95d646665213d61c8a0,51,0,0,0,0,51
1653,0x969c8a9bbd231000de22c5992cd51817e89b884d,51,0,0,0,0,51
1654,0x12399b6e77534ad49fcab0a813884f23a938c96d,0,50,0,0,0,50
1655,0xf4ae92d4e484c7916cd351c6031abbb05a0e3a6c,0,50,0,0,0,50
1656,0xe1aea37f3c892c5b34d8d9070c3250d8153e8002,0,50,0,0,0,50
1657,0x376519994387082ec6b6718f4f1d9775f5b16430,0,50,0,0,0,50
1658,0x81014aabfd59e3a3071a1db91a41374b2afe5b98,0,50,0,0,0,50
1659,0x9ced6c82326c7dbc222dd17b6573e69cfe3983f2,0,50,0,0,0,50
1660,0xa69f1ccf023007165dbf15b6ce96a6ce043e10a2,0,50,0,0,0,50
1661,0x826547bb2ec83f7d70b8ff9755c106e1c6f51c1f,50,0,0,0,0,50
1662,0x0725ce9dfcf786c620ef810635d571b8a52da612,0,50,0,0,0,50
1663,0xb2299149cdd796ab78415e80e99269e3d23d9b89,0,50,0,0,0,50
1664,0x5232ad4c600c9a60aa21a72aa33882f793946569,50,0,0,0,0,50
1665,0x4554c4e5a971a25af0c29a162761d2a0cb855833,0,50,0,0,0,50
1666,0xedb333c3756119e80ddb2400af70e5c1f7d205e6,0,50,0,0,0,50
1667,0x880b182218adc4606723b049ce1ae02c90bda20b,0,50,0,0,0,50
1668,0x5cf923dd2347e36aacd452bf210e70636c52fd17,0,50,0,0,0,50
1669,0xd64e959840ac4baa22242ef86ff3dec548f61e1f,0,50,0,0,0,50
1670,0x5a6f25c36b3e3bdaac8be765a1286aa7912cba62,0,50,0,0,0,50
1671,0x0ed74625d7d8728deb87c333f9da13217145fb26,0,50,0,0,0,50
1672,0x98fbac7995c64aa96a9df915f69e444876f698b8,0,50,0,0,0,50
1673,0x2544b9ade0a498a7bcbebd864e29878d5dd0f874,0,50,0,0,0,50
1674,0x8dc16f0d2b15040d346ddd599dec3ff8dc399ab5,50,0,0,0,0,50
1675,0x9750271f3e2c2f38cd38b29ce931f3b0d259633b,50,0,0,0,0,50
1676,0x74db22f8c148d56a2adb7da85e667526cae322c6,50,0,0,0,0,50
1677,0x96391903b37ae4a00316d508cfe4d8cf4dd03572,49,0,0,0,0,49
1678,0x3b4ff78a3386f5bec42a6e7d83510a65c84295b8,49,0,0,0,0,49
1679,0xf81139f5d1235a6c3ce7c3f6debbb3d61122aebf,49,0,0,0,0,49
1680,0xb1e03d53f6be30c7154fdf5f125e7d713ecf722a,49,0,0,0,0,49
1681,0x546f73d4291da0c1237ac9dea6326215b6b865c3,49,0,0,0,0,49
1682,0x805b1a753a13f3a8106bce41ecdad89842a4f4d4,49,0,0,0,0,49
1683,0xb5552991ce7e8bf11cc93285764d355bdbbdcf4e,49,0,0,0,0,49
1684,0xed56327c5a0ebf9043e93d784acb4c94ef3201f0,49,0,0,0,0,49
1685,0x3b55b89cacb4521fe6ab79a6868c14dc461a5641,49,0,0,0,0,49
1686,0xfebe33582ff44a820935dc9525bd9cc29543c3ca,48,0,0,0,0,48
1687,0x28c26520bd3ade82ac94a85713b051f58333ae71,48,0,0,0,0,48
1688,0x5d906f189cfb2b7182c0f9c77b06075167efe7d6,48,0,0,0,0,48
1689,0xee6af78ed834f534e3761a9c8ec117ac87028f86,47,0,0,0,0,47
1690,0x292a2fcc4575823c9190fe10ebd37556668c47e5,47,0,0,0,0,47
1691,0x6c90a82b53356cdba4a1d0ab49d9ba11de2a722f,47,0,0,0,0,47
1692,0x1728b7e3521e7f5838d4e97522cf812acfd6bbab,47,0,0,0,0,47
1693,0x7f458589dc7a95e34f73ddf72f0aae189c124107,47,0,0,0,0,47
1694,0x6e5349ff1c97a521f3f60f480d1c895b2fb79b8a,47,0,0,0,0,47
1695,0xc29c437477c7d8657ff69d1dc29b752909f894db,47,0,0,0,0,47
1696,0x651741ad4945be1b8fec753168da613fc2060c01,47,0,0,0,0,47
1697,0xd532dacff9240b9c9ab38ee1c084b0dad8035a01,47,0,0,0,0,47
1698,0x5c69a3bd32c6c8349c5bca0277578b59eb13811f,47,0,0,0,0,47
1699,0x341eae3eb086a09e8570a472b7333584f9fb3fea,47,0,0,0,0,47
1700,0x7b01429e5ade22c5b4002f0da287717e8ad05375,46,0,0,0,0,46
1701,0x7ec40a5124fd64b6255cb4f7c05dd8dbaab09e58,46,0,0,0,0,46
1702,0xea02dfd8fa539b38da9a223611bc629470bc717c,46,0,0,0,0,46
1703,0xbd816ec134b8e77254f98c07a727ef63f2909ae6,46,0,0,0,0,46
1704,0x4990e70223413059ea3da0a2d2842f0252f7aebc,46,0,0,0,0,46
1705,0xbe1f9cd7d6dd5ccde56b0b595f2f1da4578423a6,46,0,0,0,0,46
1706,0x315dc083b15e0f1e187dfc5a8462100ef726a18d,45,0,0,0,0,45
1707,0x28466609f21d3c764999f07b7163c19b291a2591,45,0,0,0,0,45
1708,0xf19aa9b58ff1e9780d866f5a3a650f5e9a439fc1,45,0,0,0,0,45
1709,0x0ec6fc29ee8a6453a323c26f3f297c1f00dd0b81,45,0,0,0,0,45
1710,0x7a4474c0f7ae65f8b5e76aafffd1cd1f5a09b9ed,44,0,0,0,0,44
1711,0x3096cebcec9e842db9fb19551099eb5e694701cf,44,0,0,0,0,44
1712,0x383f7eca9c5b1b301a3e22acd9be33fc6fa9e147,43,0,0,0,0,43
1713,0xd0ac90f29c0f040144343f0fe400f750046b9d91,43,0,0,0,0,43
1714,0xed540b08e7cae7e53a426c79f2763f9295edc812,43,0,0,0,0,43
1715,0x8d70dd4c44df13fdcb51d387e26e5460cabe23b0,43,0,0,0,0,43
1716,0xbaf31593a17bfb85f582879c817e86499bed700b,43,0,0,0,0,43
1717,0xb05e906112ff4ab38f833a3566237851a7d40cbd,43,0,0,0,0,43
1718,0xdbd855c7cc38b7d19e11a2b56b2c2130bd1a5cd0,43,0,0,0,0,43
1719,0x59ac4a74f4e3e125c84daca54581d698876655fe,42,0,0,0,0,42
1720,0x7acb0bd7fc925e27ba49d684483dc068964184dc,42,0,0,0,0,42
1721,0xdb85f9d10f5e03439464ab6b7a27a6011ce1d099,42,0,0,0,0,42
1722,0x94bdead04c63102ab62f42c6387e43391c1ae431,42,0,0,0,0,42
1723,0x3b718b6b6a68f9b7fec2ada53e159b06dde79dad,42,0,0,0,0,42
1724,0xae5e2eb6c7495259cac98f58c61935a138e7dacf,42,0,0,0,0,42
1725,0x7926f15c17a8de84792a5c71634f87d83123559b,42,0,0,0,0,42
1726,0xa870358f6530ac8ae1ebd83f1a86daa0319fdafb,42,0,0,0,0,42
1727,0x4e05c01a39b1f16d6ed0416ec19311f5ce6f2dbb,42,0,0,0,0,42
1728,0xb6f3e07aa4be9a2141d89648b9f08eafd9792dd3,41,0,0,0,0,41
1729,0x91aa31c9c3f22c1e048afac9bd9ecf64adcc4a55,41,0,0,0,0,41
1730,0xf7de460cace134de79a690e252d0a991dfcb0230,41,0,0,0,0,41
1731,0x68ce94b9ff3c94078148532a54eadc9a47964d97,41,0,0,0,0,41
1732,0x931c9cdb8111c3069b5370e67e5e3c5690f1d5c7,41,0,0,0,0,41
1733,0xe36d5123895db53adf5c462b0dfa686834667055,41,0,0,0,0,41
1734,0xa0d023aca5a347934a80310bbe749312e84f89ff,41,0,0,0,0,41
1735,0x2ccf49e7ec54d416ada3eccc678e12592c434805,40,0,0,0,0,40
1736,0x0979f650741a26b724d4ffb5fa1923528965ee35,40,0,0,0,0,40
1737,0x8bb1b626486abc8bf4bc18e81c5bebd979b92342,40,0,0,0,0,40
1738,0x2ea86b686de41f09f4eacac32b0c1ad3e1526a45,40,0,0,0,0,40
1739,0x0212aad8fc9188feed7146308e8f138b67bdf78f,40,0,0,0,0,40
1740,0x4c30df3c41d6706f596141673399808cf04ffa9c,40,0,0,0,0,40
1741,0x717aec9717d34f09128548c8bac4c45bda452b57,39,0,0,0,0,39
1742,0xa3e1b60002a24f6cff3f74e2aa260b8c17bbdf7d,39,0,0,0,0,39
1743,0xe0c545b60028861f976ef4c78de6ad18558842a8,39,0,0,0,0,39
1744,0x3a82be6f05eb63a2c2fdcb94372f726cf95a43ab,39,0,0,0,0,39
1745,0xe84344436a9ec35a66f2b23978997f5286b21648,39,0,0,0,0,39
1746,0xfc97f11fbf4e879de8b2b958ffedc76e1b2c61c4,38,0,0,0,0,38
1747,0x5f6fde0b00b3b81c6570d0960922bcf1026951b1,38,0,0,0,0,38
1748,0x9a6755a9303595bb8f0641b2917e83a73c659cf9,38,0,0,0,0,38
1749,0x55656490dc01f65981fd35308422c39ec25b7400,38,0,0,0,0,38
1750,0x1a933ad7e3ae4c5671e2fc519a77eb6700e08175,38,0,0,0,0,38
1751,0x083fb39c70a94c1e724b73fa48b8314ed8fb8f2d,37,0,0,0,0,37
1752,0xb9c426ef0a07d117dfe518bff954b19141c33c29,37,0,0,0,0,37
1753,0xa1c599bc340c32040060eee6d361a7764424ea85,37,0,0,0,0,37
1754,0x69d4efe2f8bea04d73701b7227017e37107b7a9b,36,0,0,0,0,36
1755,0x3a05b7cb3c9fb1d1871b7448a902160a9adb0df3,36,0,0,0,0,36
1756,0x0faaa4e0b3a270c1c55f322b27389b53e3c9e350,36,0,0,0,0,36
1757,0x67c0cdfdef003c1e10b096a71011e6cc5ee99c0f,36,0,0,0,0,36
1758,0x56f5c3a5ba1b4e6f741ffc6a56fc8ab0361c2d2e,35,0,0,0,0,35
1759,0x12f9fd316763e0c80e7ffb9aecdc7e4869c1f89a,35,0,0,0,0,35
1760,0x1df40f48ce18b6fa0f1c2c0987e9fcbc8d6a3304,35,0,0,0,0,35
1761,0x64a79112576b3081a5ccfe4446cc72fb6fa4eab5,35,0,0,0,0,35
1762,0x78834b429d868108d8f9b4db9b0348ef2bc23257,35,0,0,0,0,35
1763,0xe5fdaa2b1a77bc5a50039edab6886ca8b318da25,35,0,0,0,0,35
1764,0x4d06806e66063915104b1a0ab13b3b636ed6537b,35,0,0,0,0,35
1765,0x9278d1428642b62bb7972362987820242ae4e90b,34,0,0,0,0,34
1766,0x67a90a9cf27cbade6ddf6d2149f3be2fe4153306,34,0,0,0,0,34
1767,0xc89e0f05ee1d252b1a121630ec77fcc0915773a1,34,0,0,0,0,34
1768,0x546e51959179c0fc19f6f58cdf11626c00336e0f,34,0,0,0,0,34
1769,0xb24648edcd9ca7d1edcd0f7b9fb652a295d2e796,34,0,0,0,0,34
1770,0x737afdf526e2cb6d9cde52e70976051d27ea58ae,34,0,0,0,0,34
1771,0xdd21baa82528e251b24f8d10493b14eb7690b2d2,33,0,0,0,0,33
1772,0x96b1bc4c56ce3d29164da6dae9af10ecae3905fe,33,0,0,0,0,33
1773,0xc326407cc9ce7cf65b500062eabebae5c328c5bc,33,0,0,0,0,33
1774,0x0edad38fb731af9fffd6a95d3acafdb7c25b302a,33,0,0,0,0,33
1775,0x068c6a3da768b125fdf9f5c3ac52cad31c79a5b6,33,0,0,0,0,33
1776,0xb7dcca7e55cec66fdcefb2692572103d37a9d2b9,33,0,0,0,0,33
1777,0xc479b70d9b2ba741b24bc0ef1ae7c24f1ca4918c,33,0,0,0,0,33
1778,0x1acfacfaf5ec3b4ffa953f79b8fa86a7a895394e,33,0,0,0,0,33
1779,0x73eaebf38f3ae178e88de67b378f0ce6c2231fb2,33,0,0,0,0,33
1780,0x32cfdd9855cc1a56150b1fd9cc867fead63b9f4a,33,0,0,0,0,33
1781,0xc0df76e528d6d258594b444fc722e968d6ae8a24,33,0,0,0,0,33
1782,0x0d960348b05f87f2cced63146e04c9d7b04f94b0,33,0,0,0,0,33
1783,0x3a3eefac57fda64c7ec833b345d7933774a74891,33,0,0,0,0,33
1784,0xd7e774ac5cb62124068ecccaec70c44970bb9da7,32,0,0,0,0,32
1785,0x82db163f4fc5e0bd6cbce20e44b56b97107bf8f1,32,0,0,0,0,32
1786,0x69ee3f5de37d702b44a925e0029c6877b39d1f73,32,0,0,0,0,32
1787,0x3be360b9d27e2ab73a5479deda883ddd29a83def,32,0,0,0,0,32
1788,0xf346ee58a8178d398cbc3948b8bad9235d28e0cd,32,0,0,0,0,32
1789,0x2ebc61192f0771e515f44d80fb0da2c1bd55f724,32,0,0,0,0,32
1790,0x7c12d1badb11b955529988497049bbc6c6534bb7,32,0,0,0,0,32
1791,0x14d76dd2de872ca66075058088e7b13931b0141c,32,0,0,0,0,32
1792,0x06b23b4e807ad615a1ce82cf24abc6cbe618bbd1,32,0,0,0,0,32
1793,0x02676a1bfcd75f1e80020c2ca966a0bce98d0ea5,32,0,0,0,0,32
1794,0xb4097ebb016b105db5ec1d31f43983080de2c6b3,31,0,0,0,0,31
1795,0x100ea19336da070cc80acbd72223fa99b70fdad4,31,0,0,0,0,31
1796,0xfc33f6f54c553fed185cd0c4c99280dd7c64be8a,31,0,0,0,0,31
1797,0xd865a26b8c1ec80b5a6739403fd0673507cd97bc,31,0,0,0,0,31
1798,0xae87e51ba8301d53280bb8f7c0c93723f7d2ceee,31,0,0,0,0,31
1799,0x2bd8161f510f71faa7f0f54a1acb0b45d7a6d660,31,0,0,0,0,31
1800,0x118d6f5d61a9d881d452510f29c703abe9d80cdc,31,0,0,0,0,31
1801,0x9507c63acf9179d524d1006c33c991a464004fe0,30,0,0,0,0,30
1802,0x7a7fbe8bf1683fb2bfe007240ccd49adb596aab7,30,0,0,0,0,30
1803,0xf978d15b0b3737887c9187cab2178f5dd7080ca5,30,0,0,0,0,30
1804,0x12683ac692de9b90b5d15a3c7e2e10101cb7fed1,30,0,0,0,0,30
1805,0xde7963ac006ac1e4bd03977a17673ea230f4db00,29,0,0,0,0,29
1806,0x57dae97041e8ad3288634b83c8d1862930755ea3,29,0,0,0,0,29
1807,0xa1ad6477631f1c9074940047bd4cda953065f784,29,0,0,0,0,29
1808,0x8fd3c029aecccd475b971b4a6afd79a57bc7220b,29,0,0,0,0,29
1809,0xbe768802a5fc95dfc8dffe7eb324b64b93bbf1e7,29,0,0,0,0,29
1810,0x01d00704d534afbcdf2cda2df993eaf6d3dca002,29,0,0,0,0,29
1811,0xab84bbffdad3b785263a7d44fbb43a94366c3e96,29,0,0,0,0,29
1812,0x9c871e25b88d94bfe97b22223e7af01f4a85c15e,29,0,0,0,0,29
1813,0xf1ce59493205a4299d47424655a4410fdd565f08,28,0,0,0,0,28
1814,0x4f1478114cdfc609c7ac1d0aed46150cb01263ea,28,0,0,0,0,28
1815,0xb32ec9935f9131d7f3d0b3ad1c28ca60f828a395,28,0,0,0,0,28
1816,0xc2210329e161ad75415c4ee65a35f1c061717e2a,28,0,0,0,0,28
1817,0xf19471e1bbabfcd7d478ea035fe466c220866975,28,0,0,0,0,28
1818,0xce88a82eb5baf5d6b2d73ffeb2688d6022b8c953,28,0,0,0,0,28
1819,0xa0a024a8f5ff71ab89d87b904371f5271cbffce9,28,0,0,0,0,28
1820,0xa5ec51a1777ed22677cc10b3ab16d0770c239a00,28,0,0,0,0,28
1821,0xbf634020f0eb9ef4400176f32bcf470074a913eb,27,0,0,0,0,27
1822,0x2d1160bf25e15a8a3e17d8e50a9894497979c622,27,0,0,0,0,27
1823,0x6403aaa57c3ccbc48cc745f623ef72bbbcb9996c,27,0,0,0,0,27
1824,0x41fe23a48688239c5d58d50dda644978d6ca41b1,27,0,0,0,0,27
1825,0x9bfb701064f4ef0d2342b3cfbbfe464fd7fd7090,27,0,0,0,0,27
1826,0x939343bbc5d15db1c0ea0d3b01f4766a27ea02bd,27,0,0,0,0,27
1827,0xe0c07c0b755fa7ce945b8096909fba31577d14a1,27,0,0,0,0,27
1828,0xf314a30670d6719666fe44e78daf63c05c9e14f7,27,0,0,0,0,27
1829,0x1e66dfa4f1521b59ebe32dce45d8f3d7bde7e496,27,0,0,0,0,27
1830,0x09de17f529e726405852aa5f72b50d654b5c2ee0,27,0,0,0,0,27
1831,0x8f46a3d7eca5454519e7472245ed84d0ddc7407c,27,0,0,0,0,27
1832,0x41a99143529233583b69dd5257690585646b6693,27,0,0,0,0,27
1833,0x6f44695f8be5dac0c884b2bb5a401d42f8ef28c8,26,0,0,0,0,26
1834,0xc77a325d5b020e6de8d048fab192604c229e32f6,26,0,0,0,0,26
1835,0x673a53be971317b2d71f8b71fec57102863398bd,26,0,0,0,0,26
1836,0xbfafe5ce7e539e96ee1a74ce6fc0546a61fae636,26,0,0,0,0,26
1837,0x1243d99e0546aea70747c805c4dac42c8dcd16eb,26,0,0,0,0,26
1838,0xb014cb688602bbeabee54a43191a1be435baa82c,26,0,0,0,0,26
1839,0x379651764eaa77b0f8fb858ecd4c01fb090ba6d2,26,0,0,0,0,26
1840,0xb1955afbb18fb9debf356316cd6aaf297f93fc01,26,0,0,0,0,26
1841,0x5f69836b5812c174be9950c32d3faab1c545110c,26,0,0,0,0,26
1842,0x6219f88409bf0b756c75cfba80f92776d8f8710b,26,0,0,0,0,26
1843,0x1ebf4a755e979da70924ad995d559aa1e363f21b,26,0,0,0,0,26
1844,0xe1e87f85addc9ef59d6560806956f648179729ce,26,0,0,0,0,26
1845,0x5fca6b3ec00cbf468f37a9bd6a96422c7ea122b5,25,0,0,0,0,25
1846,0xe13996262ac240a586fd6945acfa6be50735ffff,25,0,0,0,0,25
1847,0xccf540d250f72dd3d2b0a41adba406f38f2c0e61,25,0,0,0,0,25
1848,0x93782058277d3bb1b7cebd3d0ac0a476c451c45c,25,0,0,0,0,25
1849,0x87dcddb5d5ceac0c516503e5eb6de9d7ed8a19cc,25,0,0,0,0,25
1850,0x1c9dc8321e8751fc94ead58e52de4038eed4b208,25,0,0,0,0,25
1851,0x2842697e04ada9b1200a1fd99371ca5bef3c6567,25,0,0,0,0,25
1852,0x9aa29c83a13da4c8d56877ec42ccaac30a157cc3,25,0,0,0,0,25
1853,0x22c46460d5dd8e457f12fc0072a18e528b6baeb0,24,0,0,0,0,24
1854,0x38b97b9fbf78c423196ea0cda490cd2496f92ab8,24,0,0,0,0,24
1855,0xb44b311ee946a254a93433d73219d151f6c34fbd,24,0,0,0,0,24
1856,0x1e0871577df868e646aeff8421f3977c7aa77159,24,0,0,0,0,24
1857,0xe298c8165ddc6f87135f1d8b2b24f2f9e95b0ef1,24,0,0,0,0,24
1858,0xafa3aa74115d62609e1bbb370178d85ea74c363c,24,0,0,0,0,24
1859,0x1b440e785a6564795ae23da5f187c330b088cc8a,24,0,0,0,0,24
1860,0xfeb8e176f4406695ec8f032af3c42d8baf934422,24,0,0,0,0,24
1861,0x31bdc06184d4533b8aa9a6e9b7c9458f802a67ae,24,0,0,0,0,24
1862,0x0b44730889ae7372a42ab5ab95ba5ede7bd8bc4d,24,0,0,0,0,24
1863,0xe04a2d9d61cd100fe3ef2394e70faac3b8a4b988,24,0,0,0,0,24
1864,0x7bc0d40357f1fc7b21bbb6199c5759d33554bbe8,24,0,0,0,0,24
1865,0x85d3845044e6ec018dc9de44d082f459854c79a5,24,0,0,0,0,24
1866,0x1d464ad6cb73cd749f4a0851805bacad531e770d,24,0,0,0,0,24
1867,0x1d9e8ea0fc9d124e6f255c45b9917ab9c2d62cea,24,0,0,0,0,24
1868,0x37ccdeea58251415df32a947e3a18809e001bf52,24,0,0,0,0,24
1869,0xbbccb88bf6aa16345158a72928c007129144b214,24,0,0,0,0,24
1870,0x32e56579b20c89f0db03d4d77466c9db13da12a4,24,0,0,0,0,24
1871,0x0a656fa14f63ce9de5d4e2e8c03c2f00918bc1e2,24,0,0,0,0,24
1872,0x54459ebd418bec372f33c89e44f09c128b1639b8,24,0,0,0,0,24
1873,0x2bcb449cc08a5d7c11181b7d137e462f29d740c3,24,0,0,0,0,24
1874,0x7980c0b271e8ed96cab48d1c99a17ca04c48f7ea,23,0,0,0,0,23
1875,0x79c7ade5b44ca217380c75e9bd2e8fbea3e83157,23,0,0,0,0,23
1876,0x822e575c2319ce476bf97f21992ddf830bed377b,23,0,0,0,0,23
1877,0x08117086ddd605ba17fab621f15c533892554cd9,23,0,0,0,0,23
1878,0x5db8ad9a84aeeae718c8b225737b2c3c78bdca59,23,0,0,0,0,23
1879,0xda58f8d6af92c270bf38cbabaa0d8f65045c30cd,23,0,0,0,0,23
1880,0x2a3131a8014a64dc2b8b576601107b666fb2fad6,23,0,0,0,0,23
1881,0xfa7ed28cf3698d36b92edb587f954d1d60dffefd,23,0,0,0,0,23
1882,0xbefebf764a9c6e092fc6ef26e5b534dc52e4dc18,23,0,0,0,0,23
1883,0xaa160c753d8a70929c5d7caa8b380335a1ecdbe9,22,0,0,0,0,22
1884,0x7fa1af37ce900a5e445244fae8e7419bf8c8a3f2,22,0,0,0,0,22
1885,0x6bf7d2c02739bacead9daa29c8c9e0fad868e42c,22,0,0,0,0,22
1886,0x65be8fd61b4bda12256cf0bb3394c1e598135c8a,22,0,0,0,0,22
1887,0xb9c43af7e3e1e7fb8c57827b10c800f700411937,22,0,0,0,0,22
1888,0x05ba46b209a3a0eeb843c5880e9345415620e65b,22,0,0,0,0,22
1889,0x7831db3f0c1367443ebf862fff23dd9c861bced5,22,0,0,0,0,22
1890,0xc5f7032bfcaafc3c2aa4a29336818f52fa586fc2,22,0,0,0,0,22
1891,0xfdef72e08ee3829e41912a63736e944fdc960f15,22,0,0,0,0,22
1892,0x31202bd15ee7c2ad7bdbea1b97fe1f2735464ec5,22,0,0,0,0,22
1893,0x27628b3660bdc43fb19fb819cbea7d262f1dd351,21,0,0,0,0,21
1894,0x9ce34d9c015c4b0957d6c252ed5dd59cbc402392,21,0,0,0,0,21
1895,0x1e53bcb46b7ccb03e96d5f1fa43bf3a2cea491ae,21,0,0,0,0,21
1896,0x8364def2570e81e67c65867307c82dd55dbb0dda,21,0,0,0,0,21
1897,0xe254e27732dfae7ac652aeb0438a30fa23b38b47,21,0,0,0,0,21
1898,0x247608a444a572a7a027d46a0d53153a622f5182,21,0,0,0,0,21
1899,0x1427cc00080f17dd10aa59e629ea3e2de14608c0,20,0,0,0,0,20
1900,0x74fd80ced283c552a668a2672e161480ef9c2c5e,20,0,0,0,0,20
1901,0x13022dbecbacf5626c876c615413d74c590731eb,20,0,0,0,0,20
1902,0x47f4fb20a447eaa5155b970f00e06336f0472e7a,20,0,0,0,0,20
1903,0xf4c4de8b87856fd008abb8be75f5e301b6f3f497,20,0,0,0,0,20
1904,0x36ed2d75a82e180e0871456b15c239b73b4ee9f4,20,0,0,0,0,20
1905,0x517b0645e0199a06e8f1b675086b66a57958b809,20,0,0,0,0,20
1906,0x4fdb1bc39ebf9cbfa378fae79983b319788f14d6,20,0,0,0,0,20
1907,0xf156198674a1d88dcfec35a310578b6cc558f2c5,20,0,0,0,0,20
1908,0x51566318dcced8e7d1184eb9e880507719eefa68,20,0,0,0,0,20
1909,0x7c49d2a802326de5e8fd5054b6b9dd180452b29c,19,0,0,0,0,19
1910,0x3bdffd63ae8a23bc197f4b44b2218b583bb21adb,19,0,0,0,0,19
1911,0x73a9a8932dc806696b32e45f5580963feff1b8ad,19,0,0,0,0,19
1912,0xe178def9c06a56ed5c87ac1c96a903b0de8700fc,19,0,0,0,0,19
1913,0x415b8dc41fa16dbc13302331b8e808fbe2159788,19,0,0,0,0,19
1914,0x8c3a77586358de1264e0dd06ac2b83af7b581fbd,19,0,0,0,0,19
1915,0xdb42316d7b1b7d03d4ea46eaeabac8e8834c7958,18,0,0,0,0,18
1916,0x2b4cd8a37677f7fe0bb964666861fd481838babd,18,0,0,0,0,18
1917,0xe36ac8c7f24eb3693d7ba3bd3f34daef808d4443,18,0,0,0,0,18
1918,0x7e9a7dc73f3773950145492cae055d75d43adf9a,18,0,0,0,0,18
1919,0x29f9bad4bf6b97b1814ef4a6b4223f81aaa6792a,18,0,0,0,0,18
1920,0x80352aa4e8d9702cea648e9209ef8650f9cf680d,18,0,0,0,0,18
1921,0x5e8f889fef6fb770dacc8a898600131cc81ea876,18,0,0,0,0,18
1922,0x72716e00633b1c656eb6718d82300f320d75969b,18,0,0,0,0,18
1923,0x08e1e8fee2d1862c3e45fc246488b1af179502e1,18,0,0,0,0,18
1924,0xf14f54629ff9ad31b8e6c224bc76da1651919e3c,18,0,0,0,0,18
1925,0x7a11ee70b07ecda33499c1bf506b1147f594d32b,18,0,0,0,0,18
1926,0x244608af2a18f1159966679105e8db66351c1be6,17,0,0,0,0,17
1927,0xca8a7efc165a9f31fc46ea7f3a85902bfb478cbd,17,0,0,0,0,17
1928,0x6ce8558cf972101cedf0abfef7f9a69bbd6d76a7,17,0,0,0,0,17
1929,0x67d4da7d3be32b7d9138b9b3528b6a4a84c41010,17,0,0,0,0,17
1930,0xbdbe53dbcdbbc0714cd9c24738c8b594c22d3acb,17,0,0,0,0,17
1931,0x744503adc5db55ef110b29b46e212bf6c39aabf5,17,0,0,0,0,17
1932,0xddc925b2f2c6fcbeefb73ccf17bf112d37f44405,17,0,0,0,0,17
1933,0xb05a37a6c77178063f57367c48e86ef53ba5b5d5,17,0,0,0,0,17
1934,0x4507f4c848103317b50cd7b0857d778039c5a993,17,0,0,0,0,17
1935,0xa0d1621b04a2771e9751cf03f6a1759c1a6df269,17,0,0,0,0,17
1936,0x21b6a65a0261360061f7d63752030eaf00401ed9,17,0,0,0,0,17
1937,0x958a4fc138bd7564101fd13b576871544deb6d5c,16,0,0,0,0,16
1938,0x758663adfb5d61238556cf74bf006bb1e1f7a141,16,0,0,0,0,16
1939,0x0baa57514db4a4b29ed6e134f394bab2b6d3c57d,16,0,0,0,0,16
1940,0x4fb86d6c613680ac726987054c5ae9dd93e777a7,16,0,0,0,0,16
1941,0x46d410b7fbaf1a2d43b48a07c15856ad258120fa,16,0,0,0,0,16
1942,0xce160afa529d4c959760243f746109518ae8cfdb,16,0,0,0,0,16
1943,0x139744b8c944fd3a5e4a05e043528c24410131d9,16,0,0,0,0,16
1944,0x403f997617ddc060d6a309f1bef2760c860ee90d,16,0,0,0,0,16
1945,0xec94e3454e00e10db33e96d8397491d853404f55,16,0,0,0,0,16
1946,0x6eca43659218d3eb1d4f82fadfe928915ccc8057,16,0,0,0,0,16
1947,0xe911308814f9d0f6167a6f817a80e660a76d3851,16,0,0,0,0,16
1948,0x7e1876cd27d2c9e6aa2f49610330b9e25d690380,15,0,0,0,0,15
1949,0xa3fef14b70377b6c4d4564d41c1d7d44365426ee,15,0,0,0,0,15
1950,0xc55873ef221a32c91acc4192ad6c0e81160969d0,15,0,0,0,0,15
1951,0xa001d85c019bda512deee6aae972226fd8e6fb34,15,0,0,0,0,15
1952,0x182464307b5f60382eee37ba1f46c575c9af603a,15,0,0,0,0,15
1953,0x8d445eee078ff46d7ddc123dac5904fad0acf92e,15,0,0,0,0,15
1954,0x45aca5e2e5dacc0ce4576655f19e9992deebdfc5,15,0,0,0,0,15
1955,0x7ece27e7cd27a0c390c83973202fb5ac66ac9bce,15,0,0,0,0,15
1956,0x16bb37c97b28a71303493b033ae39713b577cd36,15,0,0,0,0,15
1957,0x8ab913a71a9f181c4dfd051a52a9ec91dce41855,15,0,0,0,0,15
1958,0x5b1659a6d94bc6846be44505580604ac3d944d0f,15,0,0,0,0,15
1959,0x04f1a12226d9a8cfe098405ff88323e38d748444,15,0,0,0,0,15
1960,0xc32f7b7e2f35d9783d0aaa6bb4599b8d654267b4,15,0,0,0,0,15
1961,0x034a56e845e634a532372980c304964e638e5b34,15,0,0,0,0,15
1962,0x10755ff9b05e95fb57d820e7692e83ed2f60c71c,15,0,0,0,0,15
1963,0x3c490fbd8584b60d465ff8bd124bf553bd5ea37d,15,0,0,0,0,15
1964,0x7a7a71940dff1fa04c092a5f000362bd6cf6b35f,15,0,0,0,0,15
1965,0x876dcf084de703c8cda2b9f3f418a738fae04271,14,0,0,0,0,14
1966,0xda3dd1727603b1b31320e1ea08ee3949cc31c88b,14,0,0,0,0,14
1967,0x5004e28a08886ec9ce4bfb7e9d3ca8b7de156aa7,14,0,0,0,0,14
1968,0x4145ae250b1632f4df065a77b385961a30779b7a,14,0,0,0,0,14
1969,0x833411d1193e80f512b7601b3609928d0252838b,14,0,0,0,0,14
1970,0x4520064f1b01d7aa3b1a91260034786b03fa4185,14,0,0,0,0,14
1971,0xe5362637b8ee58411c7ff94ce7e49701af5f00d5,14,0,0,0,0,14
1972,0xfa9b40d315e703991050aca7ebafea3049eab976,14,0,0,0,0,14
1973,0xcc491440695de0c3c38c74e3baf0d3afea558808,14,0,0,0,0,14
1974,0x9ff5813460e0940ca2c97a21aff33642b21b9168,14,0,0,0,0,14
1975,0xc4baef35b2d54877343c7e20e46abd7985947580,14,0,0,0,0,14
1976,0xfff2da76d89d5378b99b892e2c2e7dae9b40bc99,14,0,0,0,0,14
1977,0x478a968c7e0adb79dd079bb09586b8caa3893534,14,0,0,0,0,14
1978,0x404f21bf70b3f9181c559365902a2d1cf26f8b94,14,0,0,0,0,14
1979,0x819eec1eadbbc62681168a238905afa3e171ae1d,14,0,0,0,0,14
1980,0x7af7ca67aa827f58e0659c52a641aee55a43b535,14,0,0,0,0,14
1981,0x78c4b4a8bb8c7366b80f470d7dbeb3932e5261af,14,0,0,0,0,14
1982,0x9d0095122aec8d54770c4106939a5681a96b8747,14,0,0,0,0,14
1983,0x3a7f3d4cf2ed1b4e1c9e61742c0c1ca179d441aa,14,0,0,0,0,14
1984,0xac53fa3a328e8b97fba8c00d5fc0888b1bf6f07f,14,0,0,0,0,14
1985,0x47e7ad0d9cd761e276950e8251d958f09847bc4a,13,0,0,0,0,13
1986,0xf8a1c85f3159b83c4f44c13d7e6e7d5929a4ad4a,13,0,0,0,0,13
1987,0x52b49af6ab3ed904eff4f09261d03232dbbd8f77,13,0,0,0,0,13
1988,0x7bc04f5f36ed609037f06d5188cdce15342687ef,13,0,0,0,0,13
1989,0x21687eb808f3fe92969fa1257546eaa67200d070,13,0,0,0,0,13
1990,0xe030b1ea39898028c2d360cc944f897340d4abb5,13,0,0,0,0,13
1991,0x67c9980c8c53e7dc0389c9f51f8454d393bd74d2,13,0,0,0,0,13
1992,0xac40596999e16d8c8afea023b3bf073e4a5244f2,13,0,0,0,0,13
1993,0x804de9369edb851a49013dc41cd4bf961e07d774,13,0,0,0,0,13
1994,0x289e399ed74488018f950ebb85029f5a9d2c33e9,13,0,0,0,0,13
1995,0x8fcefac865c2c00def926ed2686d9f128d567140,13,0,0,0,0,13
1996,0xad63043eeeeb837f2919c46af80362cf1592e931,13,0,0,0,0,13
1997,0xc610430e4139f1a384d61713f1ddf7a8dd9da4f4,12,0,0,0,0,12
1998,0x194eb671fd987614e87737409408601dfb554129,12,0,0,0,0,12
1999,0xf06a8f169ccc8a8fa194e1f8d6d04257228f2481,12,0,0,0,0,12
2000,0x7d8281b16308759ea3105db59a2dd3af9d18b227,12,0,0,0,0,12
2001,0x727547215d4e56d84b89fc5c1e01b74ae0add72b,12,0,0,0,0,12
2002,0x2aad3ce0f6b3f991d47cbe06d8137679b45d9a92,12,0,0,0,0,12
2003,0x8b065132b4537bf3d9ee23b930c7855417d91ade,12,0,0,0,0,12
2004,0x613600a2e2fc903b464d7fa7e139d7750f3ed570,12,0,0,0,0,12
2005,0x5802aaf121fb77530d8190cbcbda4ac8451c47aa,11,0,0,0,0,11
2006,0x191d7dc4c878cf999a12cde50c2adb6ff484dd85,11,0,0,0,0,11
2007,0x0ca2beb4fe475de208425c2929eff3140cecb1f9,11,0,0,0,0,11
2008,0xf164c55223a3453ae0bb38df97b2094ddebaea66,11,0,0,0,0,11
2009,0xdf15ba93295d92d84495cacfdfe4ba4daacdd4ac,11,0,0,0,0,11
2010,0x7d9989eca8e6560ee20fe7fa385c074790c80db2,11,0,0,0,0,11
2011,0xe6c5c458d820c4046bc2f6135b38908ddb2e09fc,11,0,0,0,0,11
2012,0x051b25066b82461d3f1fa14006843ab5ec1c5557,11,0,0,0,0,11
2013,0x4a153116f5f2f80b5c873c5d059b209254010fbc,11,0,0,0,0,11
2014,0x69ceb6204b72e69a7b51ab6a324b8d0258865a03,11,0,0,0,0,11
2015,0x97c85c03116b07ce4b77f57b75fc8d0333047937,11,0,0,0,0,11
2016,0x16b5f4bd2da9dd42f8be4949f77d84e090c374d5,11,0,0,0,0,11
2017,0x254370f7c74cdde44d1c75f727e91766f58d0e72,11,0,0,0,0,11
2018,0x0d5e3d2be22cdc05dfe8f775d7e326e26a407457,11,0,0,0,0,11
2019,0x522ad9d8fd7097240afc9bea4ce23f32b88c6ddb,11,0,0,0,0,11
2020,0xf5ccb5724ac8168ab45e01bac3ed060b595db41e,11,0,0,0,0,11
2021,0x2983fb082dda089a285f32576f350c6fbf679efb,11,0,0,0,0,11
2022,0xb2e9e5c0ed88673cd4090a7e12a8ada0b46e9f28,11,0,0,0,0,11
2023,0x2cbe750ddbd38d2f60f335a21971d9a5ad7fe5a2,11,0,0,0,0,11
2024,0xfa821245a2ad889806bc42f88bb29dba48cb3ade,10,0,0,0,0,10
2025,0x11a9583750806c3f521254c8e930991cd6139b30,10,0,0,0,0,10
2026,0xa0ddbc5fb683bf24bdd0da1611c37232fbd9efb8,10,0,0,0,0,10
2027,0x589126d65806e78c97a35ac96c7bc2a7a1256b72,10,0,0,0,0,10
2028,0xeaf07dfa2c029b595b92cba2b1f1a1e532c71d4b,10,0,0,0,0,10
2029,0xfde0680b52cb819b64e8ec93960a8c2e3dc1c143,10,0,0,0,0,10
2030,0x107674310bd325738add1d12b98831c792e84130,10,0,0,0,0,10
2031,0xd93f65a4171e83b9d15f5f28ee3ffd5bf5144ebc,10,0,0,0,0,10
2032,0x576bd377d281938910820f104252ca5790e38229,10,0,0,0,0,10
2033,0x97839f73d2c5f5e603e1eb35ebe5d375d0dcbcb3,10,0,0,0,0,10
2034,0xdd8eb948d183cce99516fcc5b2a1d16ef7426691,10,0,0,0,0,10
2035,0xaeaf1a62bcbad6cd0f5ac385d4f4640f4f3efc67,10,0,0,0,0,10
2036,0xba9c0ed31218c4c9f943a3ca6ecb077eb853af80,10,0,0,0,0,10
2037,0xf782b44f8b4ccd13a45ed279ee3f23f31636207d,10,0,0,0,0,10
2038,0xa508c76a76dee5fd2c8c6948ea1e68776eafe472,10,0,0,0,0,10
2039,0x2ca2ae442e68ae80d8a4f5e2c57566f7c36e2075,10,0,0,0,0,10
2040,0x1b7f18d859ac31734eb6dd69fdb81c0cfbf2cba4,10,0,0,0,0,10
2041,0xc14a3a7a5c85dfd042bf38e59bb347534eb27cd7,10,0,0,0,0,10
2042,0x0dd51fb6bcda54203056e9666299ab9cd453ef82,10,0,0,0,0,10
2043,0x701e17f803d0440f91d3db1e53be7547d76723f1,10,0,0,0,0,10
2044,0xf81adaa5f6e566c1a445787e21a4665191cf981f,10,0,0,0,0,10
2045,0x7983b998c4fcb826f6cf2f0b177e7711650761e6,10,0,0,0,0,10
2046,0x04dcc751e98ca32fe36b4e34d8c582f852b6c732,10,0,0,0,0,10
2047,0x23b258e9a441a86f69a8381b2437da94c42b5023,10,0,0,0,0,10
2048,0x54b8896cfd65fd28e886f883fe14995f1a05c6e8,10,0,0,0,0,10
2049,0xe9665333e0b0ddb629dfeca6cc8e24151cfdc284,9,0,0,0,0,9
2050,0xdd5a81ee4c853db84807c212808c64ae5aa7dd34,9,0,0,0,0,9
2051,0xb4002829c43d07f4409978577108a48d5430859d,9,0,0,0,0,9
2052,0x34465000b49a8e4592ec887de04835b79236cc8a,9,0,0,0,0,9
2053,0xda6e1bf149f7ea91399adbe2a7b038323a246933,9,0,0,0,0,9
2054,0xccc9a5bb279cefa2e1e38ba5cfeddb1afdf726ea,9,0,0,0,0,9
2055,0x3128149fdc8be648012baf38e3d3fd1a0b88e217,9,0,0,0,0,9
2056,0x69a14d75acc5bfe73308598ca2110ce0794d764a,9,0,0,0,0,9
2057,0xb851c3bb953c069410415d4f3412ecd0d6a903ec,9,0,0,0,0,9
2058,0x1da7f445f4b209982d58619a2031ac7e5ab7d5e3,9,0,0,0,0,9
2059,0x038e701d1b17d35f7c263368738fa27722524817,9,0,0,0,0,9
2060,0x7b8ab894bdaf870ab3fe01e1e1b2bcddfbac2176,9,0,0,0,0,9
2061,0xab966555c802b8617968a9f6ca1f95e964757996,9,0,0,0,0,9
2062,0xa83fa9c834bb5abe25f9c56eb5845b3203df94f2,9,0,0,0,0,9
2063,0x65607550d5d8233772ff5f09b668151381e80c12,9,0,0,0,0,9
2064,0x6df6f49809a6e32f3f1d00fe810da70396d47675,9,0,0,0,0,9
2065,0x54e6f151504a660cd114b5841fe32e9832f76aa7,9,0,0,0,0,9
2066,0x6276bb9ae2d7fd555c389852cbc5aca7cb3e9eec,9,0,0,0,0,9
2067,0x0913adaecd9497261de4f3803bbf56b85f309c5d,9,0,0,0,0,9
2068,0xb40d90fc1ae1b0d85f9409aa3c831f67815b16bb,9,0,0,0,0,9
2069,0x974ff2412dfc419513274425c5d2fee353d7a3d5,9,0,0,0,0,9
2070,0x71c4cedbc30087a221bb96cfb5a61033e1b0a3a6,8,0,0,0,0,8
2071,0x36a5120a30a868f346e302fcec3ef3cda85d67ae,8,0,0,0,0,8
2072,0x0c95aba960623b0dfcbfdbed35fa0a642b7080b0,8,0,0,0,0,8
2073,0x639773f667b7bc38ff8f3518be45cc30fd93509f,8,0,0,0,0,8
2074,0x579faa6ee6596c4a30b78b6fd20bb9e20967504c,8,0,0,0,0,8
2075,0x564349b24e4bc35b24577b587bdf49baa11e87f7,8,0,0,0,0,8
2076,0xbe06fd75ac83f355f78c6540ccb25c9807f533dd,8,0,0,0,0,8
2077,0x33610b864185c4545d47e0aa3bf222a43e3e96c3,8,0,0,0,0,8
2078,0x4ebe0e733195e5867f329f0a9e09c91e9aea8f30,8,0,0,0,0,8
2079,0x3e418f8cd4e8ac74365f941c81de579377401a01,8,0,0,0,0,8
2080,0xbc108b8b6d131251bbe387c34ffc746c1a7e3fe5,8,0,0,0,0,8
2081,0x26c233534aee8732cd3aef25a1a50cb94083f32e,8,0,0,0,0,8
2082,0x106d3ca2beaff17a8813a51058a63a82ca4425b8,8,0,0,0,0,8
2083,0x62c745f6b91b0011d4951e71a626634809726c40,8,0,0,0,0,8
2084,0x5313fd7885f656cbd2e174b1662af17bbbf75e20,8,0,0,0,0,8
2085,0x885e4b13f433d5c7383e068deebadc03e6920a8e,8,0,0,0,0,8
2086,0xd81436122075b3f835be22ba78351a2c12c575e6,8,0,0,0,0,8
2087,0xd4e8672cd8cd86c3e5d3ee475f169b610ed9d429,7,0,0,0,0,7
2088,0xe0facb4c7845577016919b3e193596545177c333,7,0,0,0,0,7
2089,0x9209eb1d037b2e90ed0545fe14743597738522e0,7,0,0,0,0,7
2090,0xd024c44054e7790a7916d9c95628f565625d31b8,7,0,0,0,0,7
2091,0x9473fc9d09920b878afb714e3866e1d374fca0a5,7,0,0,0,0,7
2092,0x1701db833ccc91f9f45c448a311c32e92d25d1a9,7,0,0,0,0,7
2093,0x36d424d17c458893119e300c79c66dea0a0f7972,7,0,0,0,0,7
2094,0x035b5989b3d5ac9f8421613065cf5dfc9835ef6f,7,0,0,0,0,7
2095,0xb1708258b9cd32cbe8c15691cb82d3aacd109828,7,0,0,0,0,7
2096,0xeaa24fccfde5acd7e5a791d7cfca8614b4c2fb61,7,0,0,0,0,7
2097,0xd0ff3e387a2ad23841fe60adcb3cf28b46ba7a14,7,0,0,0,0,7
2098,0x43fd97693e5dcf622aaffe2d9d1c09d5720d107b,7,0,0,0,0,7
2099,0xb32e58b9db3fc1a09d3d67112600edef20ee1d2f,7,0,0,0,0,7
2100,0xb80a3b585d641f948064ffe375551cf488ba676d,7,0,0,0,0,7
2101,0xc524dbca60d5ced3358c4b9a7e8a3963f433b88f,7,0,0,0,0,7
2102,0x4ff80b769f4cce9439c878e153eadfa972549442,7,0,0,0,0,7
2103,0xba4a602bf1b9c92b9c141b422aee0b759750f9be,7,0,0,0,0,7
2104,0xfb1369548e5b8768ca2c3ada0556606bd7d8b615,7,0,0,0,0,7
2105,0xd8b4e8851fb5930c2f2db28d6e3dd25be34a0b8f,6,0,0,0,0,6
2106,0x1d893978d53f2a365fe5b0605fe7f952a47e06a9,6,0,0,0,0,6
2107,0x5e1e5a86a035586805cf1768c882a3153e4e4cea,6,0,0,0,0,6
2108,0x532c08503dca4e8777af14300ee5d0156ad98ec9,6,0,0,0,0,6
2109,0xc080e89966ec15c6d704ac793f86c26973e677d1,6,0,0,0,0,6
2110,0x1c4049b889c985bf99e733f194192517d6a4c4a3,6,0,0,0,0,6
2111,0x81f5a934cba5ae39a60634c90120f53ee14782dd,6,0,0,0,0,6
2112,0x62ba31a9c94116aa9ebf926b919b9289cefca6f8,6,0,0,0,0,6
2113,0xc4ffe88aaf117c5cadea8d424edbc25555a42e9e,6,0,0,0,0,6
2114,0x170fcd5c519bcc48068a1b177edbb6c16b792b88,6,0,0,0,0,6
2115,0xd15173eb7ddb2d99c3e07ad9051c91a2cac40ead,6,0,0,0,0,6
2116,0xd42726c150592152a7ef3bcf5383e1a6aa131c92,6,0,0,0,0,6
2117,0x8ad36dec0118bcc23cc4da53235d50a123061bf9,6,0,0,0,0,6
2118,0xb899f88b33ef906b42ca5429e94ea91638aabe67,6,0,0,0,0,6
2119,0x67e1159841fedae0cd9360c28d65f4a9872b71c7,6,0,0,0,0,6
2120,0x9a22ff3a952e30d10765926d11d88506291df8a0,6,0,0,0,0,6
2121,0x4b9a166b94037947cd44baf6d993be0eb1240447,6,0,0,0,0,6
2122,0x8fd7432c3bff1316d473b81e3c1e1151423919ce,6,0,0,0,0,6
2123,0x140feb867aa2695204aa7a23c356856a055db04c,6,0,0,0,0,6
2124,0xa23b4589d9f4cc1ed4e7cbfe3887c774585cf4f2,6,0,0,0,0,6
2125,0x09d78ed84b5e8ae695197849920bf28e4a7dfd86,6,0,0,0,0,6
2126,0xc6fb8ac9f7c41acf42022add8d7cabcc7a8ddee1,6,0,0,0,0,6
2127,0x4a1a0aeea2a03ed451b577f51f1d7e5568f29736,6,0,0,0,0,6
2128,0x93c46c08b724a574dad18241fd7b5373652b597c,6,0,0,0,0,6
2129,0x71ef3244fdac9168ee3382af5ad99da09632649a,6,0,0,0,0,6
2130,0x449c5e1c621d00df4e4b51ea5324b6df54d5d11b,6,0,0,0,0,6
2131,0x787dbb6edcb7e0a12edc5504c8c9fe92eefae623,5,0,0,0,0,5
2132,0x0fd212d499730ae00ae7b8a4580f7a268e42b3fa,5,0,0,0,0,5
2133,0x105e7ba0c4fff4f3cae0488319496d44b7c84a18,5,0,0,0,0,5
2134,0x98acd7b4cdb83ab8065f5ba0d92833bb56099e1f,5,0,0,0,0,5
2135,0x04a826369b69cc9a577e9579b45f58c91a141c37,5,0,0,0,0,5
2136,0x8ee9f99ca90a3be12e77e16fdfdc189952935e0d,5,0,0,0,0,5
2137,0xdc2beaadd4474c98b6fa14fffe134c62aaa978e0,5,0,0,0,0,5
2138,0xfcee234f00e0a1de86cca300ddc6f005045df765,5,0,0,0,0,5
2139,0x66eaff9777159181c26966f9b857256b12a3f940,5,0,0,0,0,5
2140,0x32d1517c078da714874695462041a78a3a583d85,5,0,0,0,0,5
2141,0x0ce3e73471a5928ae3fc5e685a163367f1bc8ead,5,0,0,0,0,5
2142,0xaf2e919b59734b8d99f6bc1f62dc63d6519d14bc,5,0,0,0,0,5
2143,0x222d60a8c22fcfd76718fbf9cbf5455f61cb6258,5,0,0,0,0,5
2144,0x05755782779976e30ed8367ee4fb8ffffd446809,5,0,0,0,0,5
2145,0xddf403807c103624d3ccee729a88103f3fb55cb2,5,0,0,0,0,5
2146,0x2ba4ae06460700c661cfbba0b4cdebc227ea72ad,5,0,0,0,0,5
2147,0xa358bdfa784b134ba8010454ffb1dc10a6032cbf,5,0,0,0,0,5
2148,0x9d791f0a164820ce00bf2d027acd5fa24425099a,5,0,0,0,0,5
2149,0x29c3fe5c8e84e5e62d0e7ec4aae5a48ae0b27c99,5,0,0,0,0,5
2150,0x77c63295278ee2c47c18149661857484136e28d8,5,0,0,0,0,5
2151,0x9799be3a5be5a505f09982cd8c905b87fe498bd1,5,0,0,0,0,5
2152,0xc415dfc107fd4aa8bd96b06889c7c30bd7e83490,5,0,0,0,0,5
2153,0x33cd35c808a8c0b379314c5e129c1331ee4a2113,5,0,0,0,0,5
2154,0xebe8007f9fc0ef1eb331699521112db0ac41434b,5,0,0,0,0,5
2155,0xf2f84390382c2bf2b8482343f378aafcbc543a6d,5,0,0,0,0,5
2156,0x3b687413af95e427166769a8b03b102f9393e1de,5,0,0,0,0,5
2157,0x8c1375e561099370b2dfa9b7dc2c0042ce41f1ed,5,0,0,0,0,5
2158,0xf2ee2aa7cdeabc6aba8e51ea020ef67d17c13b72,5,0,0,0,0,5
2159,0x09092ffe55ae28a67d369097bb3d804346afddea,5,0,0,0,0,5
2160,0xbfb51c656109999754ecaf8d622494408875e359,5,0,0,0,0,5
2161,0x82d8c41389a59fe13ff6fb4b0b969cc36cccadbb,5,0,0,0,0,5
2162,0x5fa101320dfb9da0f17324c60b184bedcbf22296,5,0,0,0,0,5
2163,0xdcc81d27020ed7531951617b4eeb060694ea1601,4,0,0,0,0,4
2164,0x7de08daa364e286935998deefcb22ab5f7f5a92f,4,0,0,0,0,4
2165,0x4ef33c2d772e69ad25b44b219ac47c53e0e46f53,4,0,0,0,0,4
2166,0xa4809d50d952cad0032ab56cc6ba24c8a0ceee83,4,0,0,0,0,4
2167,0x6ce8be21566e4715db5884a25ae496feb1abd05b,4,0,0,0,0,4
2168,0x9391f5b85c85c6e7d60f8039963390e73ce64f3c,4,0,0,0,0,4
2169,0x2a14cee41a5a9bb429229e429d04a753381a686a,4,0,0,0,0,4
2170,0xd4275205586a44d8e62a7e5170befdd949012a64,4,0,0,0,0,4
2171,0xcdd5f69b2ec7b31325a44cb44219ce48500ff68d,4,0,0,0,0,4
2172,0x32016e1ede4ba858a646ae05495910b6fdeb6076,4,0,0,0,0,4
2173,0xf1e8925a10f929065b72587e792c4d45e7da232d,4,0,0,0,0,4
2174,0x8fbd47203a344f29f0c6cd60e605b843130baf06,4,0,0,0,0,4
2175,0xac9bcf589f631bbbdceca51742ef768eadc49703,4,0,0,0,0,4
2176,0xb4cf1ed1667a7bd00ef279655f2f6b1ec397e8b0,4,0,0,0,0,4
2177,0x22db9e62319067bb41127d9665910e91ae682f33,4,0,0,0,0,4
2178,0x5a769efc39b1a13121c7247e68d80f37dfde8fc7,4,0,0,0,0,4
2179,0x7685b0d8a634792150d2ffd45507034785f892e4,4,0,0,0,0,4
2180,0xd174a34489a854b31f7b39c46b4112628d26e1ef,4,0,0,0,0,4
2181,0x4c89e06c59a3185d0cab45a4a89712c4ad3ce1a2,4,0,0,0,0,4
2182,0xff966e4d8f2dc829364b403f4150bba85ca03c04,4,0,0,0,0,4
2183,0x817adc7457a4c53a1df68158662aef57a8881770,4,0,0,0,0,4
2184,0x3d5660e507c6028bd2ee8aeca0b829cb54e77498,4,0,0,0,0,4
2185,0xd5ba12884d41dd4c1691665bf339f0f595ad6c0f,4,0,0,0,0,4
2186,0x98cdd4f4983c27aff5f6fa9c7f7dd4cc055d964b,4,0,0,0,0,4
2187,0xd1591f65ea0a300788e50b443ca43e390b63f9b4,4,0,0,0,0,4
2188,0xc9d456c1419fb311e4e98a607defc0103cd7fa95,4,0,0,0,0,4
2189,0x0333d3cd3b91ed0b64b33b96f5b98bc5132e63ef,4,0,0,0,0,4
2190,0x28d7f2c7652b89120e4057169d0ec02a5de0b7b2,4,0,0,0,0,4
2191,0x3716e0754a0621d757988ea7e04f1b2b8e906703,4,0,0,0,0,4
2192,0x7308e0b695fdc7b594e06df37fd0bbe93a08b27d,4,0,0,0,0,4
2193,0xf052ce745eb24643de6709eb40b21f4a791ced56,4,0,0,0,0,4
2194,0xe11b0a4dbf35080a6b9ddbbe141e117d4a37cc99,4,0,0,0,0,4
2195,0x21f7e5ec47db38302e2b3d666f67f594e4cb7541,4,0,0,0,0,4
2196,0x1b2ec57bbea01f59b41d8c5bad32783ad3fd3f59,4,0,0,0,0,4
2197,0xe316cb8dbb22d55590d47ee6672eeec47a727e53,4,0,0,0,0,4
2198,0x611ce6b34179c594bf6bfd4f4ce21f094e5c2b2a,4,0,0,0,0,4
2199,0xa037338610a590b93505053b7255db0d81b42972,4,0,0,0,0,4
2200,0xf9c8ceb003a590b38ac2317b7c019454f97fa458,4,0,0,0,0,4
2201,0xb40467facecd7df0f96bfd00da2c35a4b4502981,4,0,0,0,0,4
2202,0x9a0f078c53f5fe786c43b0858a05c6def0048552,3,0,0,0,0,3
2203,0x542d9744e430bb1657ea17651d72f405ee899be6,3,0,0,0,0,3
2204,0x97bf5ab38f679eb91f7e8d56d166344d775afad3,3,0,0,0,0,3
2205,0x596d74bb913a2763c1ccda920d06b7d6f1b0e82f,3,0,0,0,0,3
2206,0x74dbb201ecc0b16934e68377bc13013883d9417b,3,0,0,0,0,3
2207,0x1b5ae9f538110316838414fc58d35e8826201af6,3,0,0,0,0,3
2208,0x917a7277903148cda75c4e761ed7f483470ea28c,3,0,0,0,0,3
2209,0x4ee7e2bf38d9a6f8cab33139d57bbac61b2185d5,3,0,0,0,0,3
2210,0x8d52b1bf882d0fd1810bc942bda2d9b42537ef79,3,0,0,0,0,3
2211,0x26c596f0e400dc16ff7c1575a72884cecabf8cc4,3,0,0,0,0,3
2212,0x3183f9ee921781d4b0d983089b82b7b2b06d6536,3,0,0,0,0,3
2213,0x7e283c385737e4cd026a29572aabafc1053908cb,3,0,0,0,0,3
2214,0xdcaafc4578dadac839a5834cc53433da191f3d44,3,0,0,0,0,3
2215,0x3c3b3dd7a4096826587abb2f2f989ea89eca163f,3,0,0,0,0,3
2216,0xb4a116e80c276871a6b49d19a059c2837d352836,3,0,0,0,0,3
2217,0x6d62eb146522b30336fb57cd063af69618f62675,3,0,0,0,0,3
2218,0x2747666cb0d4c0c4284f11e28439918d66e727c0,3,0,0,0,0,3
2219,0x890046c32e288882e2e4560afb51cca661a909cd,3,0,0,0,0,3
2220,0xc42a9a5ec173bb8db29705f012025b6ec5237e6a,3,0,0,0,0,3
2221,0x21fd5e9ba1a102824263c42dd265a465cc69e469,3,0,0,0,0,3
2222,0x932c2a34cf8488e7a76a0453e4c6a0dc5505a470,3,0,0,0,0,3
2223,0x0443cb4ef5b9b4be85d6b7010b90e7761c556df8,3,0,0,0,0,3
2224,0x8ce8034153147edeac908ecc71353b672f62407c,3,0,0,0,0,3
2225,0xec08440cdc4b4de6778ec02b3fa8d471129117fa,3,0,0,0,0,3
2226,0x4bab943112d3335fad0cd6c5cfe4fdf2959d80c8,3,0,0,0,0,3
2227,0xfb99a9bb89dcb9cb4958a34a36657edc8e3e6b6c,3,0,0,0,0,3
2228,0x2950db74e497aa48b6b53f56d826f465e99daa55,3,0,0,0,0,3
2229,0x19a23bda7c6c09e691454e1be07faa54c4b9d9da,3,0,0,0,0,3
2230,0x6c52d274ac246fb29657756941ad1c158004bf99,3,0,0,0,0,3
2231,0xecf5c6c184457e4797860ca92044841a140f0468,3,0,0,0,0,3
2232,0xad091acddf641b027702957d4d16801989ef230d,3,0,0,0,0,3
2233,0xe7f9ae62d7734552c3e4b185c1161513e3189d69,3,0,0,0,0,3
2234,0x997fa81edeced451015e0089fd48de76dc2f9beb,3,0,0,0,0,3
2235,0x0ad5e827daad20f5635923ad824968b062d673a3,2,0,0,0,0,2
2236,0xadd3cc36864569e4a5d90854a0c54217a13fd81f,2,0,0,0,0,2
2237,0xce22ee7d64e96406d23a496acb280e514202eee3,2,0,0,0,0,2
2238,0x4006e7e3d4a25c01ad03e76e074f4a4b6e84648b,2,0,0,0,0,2
2239,0x34a776f4d26bdaf9f943031cb1c638e6c91efe6c,2,0,0,0,0,2
2240,0x84bddc62a33a2119b7dcedfbffa0c40a4d29d008,2,0,0,0,0,2
2241,0x161bd5b2160067bd57931b9843e73eaf851dccf6,2,0,0,0,0,2
2242,0xb1f1ef4ef29e1ec5dbd6ff8463c4ef503fef63d5,2,0,0,0,0,2
2243,0xbd4d6c1ddef3fe672665454d7ab69f5b370f8762,2,0,0,0,0,2
2244,0xbb207e6721486ed0e900a7917894215cb8d186d5,2,0,0,0,0,2
2245,0xf17a1e996714b90e1cf3ba7cd347979094fb77bd,2,0,0,0,0,2
2246,0x2881a049597d03cb65060e84ff96d0d8a257b37f,2,0,0,0,0,2
2247,0xa8f190e487bd08ad468f9e50d4c913bcd8f18614,2,0,0,0,0,2
2248,0x4e750384b4f692e6052df91809cd53cf9a4eafd6,2,0,0,0,0,2
2249,0x95ae31936a9b2d11debda9d5d19c6d7d021fb6bc,2,0,0,0,0,2
2250,0x98532fa1dfea60e03499ea02f747d7e12d801dc0,2,0,0,0,0,2
2251,0x77d4be9af7639fd959c0274a55d300c00c2a928b,2,0,0,0,0,2
2252,0x9d851470da0c630dc43cbccd146b36fa279d45a1,2,0,0,0,0,2
2253,0x662688e2ccf73de45932ff0ff67af2151f4f616f,2,0,0,0,0,2
2254,0xb820c7efae72d72187931f30b9df4c2470e85928,2,0,0,0,0,2
2255,0x51bcc22cafb1e45b3554d46d0bf3e022883b38ad,2,0,0,0,0,2
2256,0x0b6e1e24a0153c608e2a64b600c557f92e9f63d9,2,0,0,0,0,2
2257,0xa9c6ebd02fbe700818cab7628b961dd86ea95290,2,0,0,0,0,2
2258,0xd9ae4ea38fbc904550a4e242aeac885ac12cb9a1,2,0,0,0,0,2
2259,0x467b6ec2cf90b104320d9056946b0a483157aabd,2,0,0,0,0,2
2260,0xd8e9a50d4105dad15dbab698467db2d2e52226d0,2,0,0,0,0,2
2261,0x98f5e6295fe68dce1aee28b73fc70df35db880b9,2,0,0,0,0,2
2262,0x12be22b711bef6366a7b7401db473e9dea966f04,2,0,0,0,0,2
2263,0x4b4c44c42b7dbb1e8d1484f02370ab5e1619ea1f,2,0,0,0,0,2
2264,0x7e945c160d1d2bb3fbb6237ecbc4b1e835093295,2,0,0,0,0,2
2265,0x531785d28605b2056fa0f97462da5eecfbbe6ff6,2,0,0,0,0,2
2266,0xea9f9d464a5cf984b5c27cc90fabfe78a12482c7,2,0,0,0,0,2
2267,0x020cca6017129f9eb7ea38f14affbe8690f98811,2,0,0,0,0,2
2268,0xbc750e75c42d1d9d86772b7fcde00c6d33887518,2,0,0,0,0,2
2269,0x381f72eb9d830b6f75e5507f3775aadc45a75486,2,0,0,0,0,2
2270,0x309515a2e5a060a6141aa1f9bb090e0dc31927c6,2,0,0,0,0,2
2271,0xe769923e53f50bc2a4fae8cce134b8913aea9f85,2,0,0,0,0,2
2272,0xb17296127047810823be1ab0311e8646328d3947,2,0,0,0,0,2
2273,0x19d7b4d403a9d3dc5ed3b15ea88671816b0f1d9f,2,0,0,0,0,2
2274,0x2fd227591fe6c67ef9e5ea1508d3a4dc3eece312,2,0,0,0,0,2
2275,0xb52bfe1235de64dfc0790e994749d30242a3e830,2,0,0,0,0,2
2276,0xf8710aa5109a18f4b050b5a8d2dc6c8f528e053c,2,0,0,0,0,2
2277,0x49a0afbcebd87aec3242afb9c53044354b5f8c34,2,0,0,0,0,2
2278,0x21f084c49d465f882e1c7fad930fe69f120bad7a,2,0,0,0,0,2
2279,0x20ced49ded2a77eedb573a6e5aa227c6e7a73f47,2,0,0,0,0,2
2280,0xc6da2986e9c73365dde4e4a800234d47c3f6e14d,2,0,0,0,0,2
2281,0x86585b751c8ed620fba3bdb043d7ed2a125b6e01,2,0,0,0,0,2
2282,0x8fc3c1ed1a4a3d03f1575300b6dfbaa491e92531,2,0,0,0,0,2
2283,0xf54d5bdc76811e49a67c4f1036db7d244554af70,2,0,0,0,0,2
2284,0x2280665986bedfb7ab9baf550989d2afa7076ec6,2,0,0,0,0,2
2285,0x3885642da83667a7e48b8ee5c89b166dedecc907,2,0,0,0,0,2
2286,0x96e67b46cd31c367f12bf5d240af6f5d3b57d1a3,2,0,0,0,0,2
2287,0xba716d361a81cd41e9d70634b8582d92f2cc745d,2,0,0,0,0,2
2288,0xf419a89b3ed7f061fd7cbfa4a61eca7fd5c81358,2,0,0,0,0,2
2289,0xd8b716e96dcebdf8fabbb54a7685598950fda51a,2,0,0,0,0,2
2290,0x144294d68e2a7b37f3a90e3a397349da54aeb945,2,0,0,0,0,2
2291,0x00aff2d72e92db35e3db58ffca62b3fc72b97422,2,0,0,0,0,2
2292,0xfa0ad06ab9c0eb26c9f9f4be7a3411d478f9838f,2,0,0,0,0,2
2293,0xde9c9d184e2bd5e745bdbe26afe5808fbb6ad1a1,2,0,0,0,0,2
2294,0x373c6000f9ab0d565e02f1226346258b4af5d387,2,0,0,0,0,2
2295,0xfdd6cb90b3bd8f9cf138a6f3880254afcb10e69a,2,0,0,0,0,2
2296,0x5b010ed45fff93d45a7af6afca2e5fdac8557c91,2,0,0,0,0,2
2297,0x1a95ce42fb14b08352321d30c521d43c7cdf10dc,2,0,0,0,0,2
2298,0x0a31a465241935f857a7449cc8c2b63814742173,2,0,0,0,0,2
2299,0x6ed0a5a86696b798bee8a81c76187c20d1813e3e,2,0,0,0,0,2
2300,0x3e368e629bbd7920bbe99af5eed711d6a603cdea,2,0,0,0,0,2
2301,0xcc2ef4fe4094e90dddfc80cdf4968b1ec8b0d24b,2,0,0,0,0,2
2302,0xd977ebe89cf5e8c7715735d02b43510cb552aaa9,2,0,0,0,0,2
2303,0xd4c53c9ef3d3cd8285565b78ca71e9832b4b287a,2,0,0,0,0,2
2304,0x20bbd5aa8fe8b84b224fd98e0b62c097bf9bc401,2,0,0,0,0,2
2305,0x2dabd30ccd5262a522d323d52e11b9b92ac209e2,2,0,0,0,0,2